first: inaugural, maiden, commencement, low, showtime, initiative, kickoff, initiatory, outset;
people: masses, mass, citizenry, multitude;
still: however, allay, nonetheless, tranquil, placid, soundless, tranquillise, calm, motionless, hush, unruffled, tranquilize, even, quieten, nevertheless, tranquillize, inactive, withal, lull, yet, noneffervescent, notwithstanding, ease;
world: existence, globe, humanity, populace, reality, planetary, humankind, domain, global, humans, public, macrocosm, man, mankind, universe, cosmos;
great: outstanding, groovy, peachy, corking, dandy, keen, smashing, big, expectant, nifty, swell, majuscule, enceinte, bully;
right: flop, redress, good, compensate, proper, correctly, decently, properly, rectify, veracious, justly, ripe;
around: approximately, some, roughly;
state: country, nation, commonwealth, province, tell, posit, DoS, land;
found: happen, rule, obtain, bump, feel, ascertain, base, institute, detect, regain, incur, retrieve, get, launch, constitute, see;
place: pose, set, lieu, rate, seat, home, aim, put, stead, piazza, property, send, invest, site, localise, billet, post, situation, spot, shoes, rank, berth, localize;
small: lowly, belittled, little, minor, low, minuscule;
thought: view, reckon, imagine, intend, recollect, cerebration, intellection, persuasion, idea, conceive, sentiment, cogitate, opine, cerebrate, suppose, mentation, mean, believe, retrieve;
number: turn, act, routine, bit, come, list;
course: path, flow, form, line, row, feed, run, naturally, trend;
united: merge, connect, link, join;
think: conceive, reckon, imagine, mean, believe, cogitate, opine, intend, retrieve, cerebrate, suppose, recollect;
school: cultivate, educate, civilise, civilize;
better: wagerer, well, upright, substantially, salutary, unspoilt, considerably, respectable, skilful, intimately, skillful, improve, easily, estimable, ripe, practiced, amend, beneficial, comfortably, full, adept, unspoiled, dependable, ameliorate, meliorate, advantageously, good, just, proficient, safe, near, undecomposed, dear, honorable;
house: mansion, firm, menage, sign, domiciliate, theatre, theater;
night: dark, Nox;
called: ring, bid, shout, hollo, yell, prognosticate, phone, telephone, foretell, name, predict, cry, forebode;
system: organisation;
going: choke, sledding, blend, croak, rifle, departure, last, fail, get, perish, plump, expire, run, loss, pass, lead, survive, expiration, work, move, live, endure, fit, proceed, die, become, conk, decease, depart, exit, locomote;
asked: necessitate, enquire, need, inquire, postulate, require;
point: show, bespeak, channelize, aim, betoken, sharpen, channelise, taper, tip, peak, manoeuver, maneuver, indicate, head, designate, item, manoeuvre, steer, stop, luff;
program: platform, syllabus, broadcast, plan, curriculum;
given: dedicate, minded, open, make, contribute, precondition, feed, pass, hold, afford, generate, apt, presumption, pay, tending, have, gift, impart, devote, collapse, consecrate, hand;
present: nowadays, portray, show, face, salute, give, gift, introduce, demo, award, confront, demonstrate, acquaint;
looked: bet, depend, reckon, await, face, attend, wait, calculate, seem, see;
order: guild, arrange, rate, club, edict, society, regulate, enjoin, put, say, regularise, ordination, gild, rescript, regularize, dictate, fiat, consecrate, rank, tell, prescribe;
business: occupation, clientele, byplay, job;
thing: affair;
later: previous, tardy, subsequently, former, recent, posterior;
social: mixer;
large: bombastic, big, prominent, vauntingly, orotund, expectant, gravid, magnanimous, boastfully, declamatory, enceinte, tumid, turgid;
power: king, baron, exponent, magnate, mogul, mightiness, ability, tycoon, might;
interest: pursuit, sake, pastime;
turned: bend, ferment, rick, plow, deform, become, wrick, wrench, off, flex, work, plough, sour, sprain, grow;
light: sparkle, luminousness, swooning, abstemious, wanton, dismount, sluttish, illuminate, scant, illume, luminance, unclouded, wakeful, tripping, idle, perch, twinkle, illumination, illumine, promiscuous, easy, fall, unaccented, weak, luminosity, unhorse;
began: commence, get;
sense: signified, feel, gumption;
development: evolution, ontogenesis, maturation, ontogeny, exploitation;
matter: affair, topic, weigh;
whole: totally, all, unhurt, completely, unit, entirely, altogether, unscathed, unharmed, unanimous;
certain: sure;
action: fulfill, execute, accomplish, fulfil, sue, litigate;
example: case, illustration, instance, lesson;
taken: necessitate, charter, ingest, consume, deal, pack, fill, film, get, aim, lead, postulate, read, require, hold, have, subscribe, select, hire, withdraw, exact, choose, rent, need;
experience: have, live, feel, see, know, get;
death: end, demise, destruction, last, expiry;
president: chairperson, chairman, chairwoman;
brought: contribute, play, fetch, wreak, take, bestow, institute, add, land, lend, work, impart, get;
question: dubiousness, head, enquiry, doubtfulness, interview, interrogate, query, interrogative, doubt, inquiry, interrogation;
moment: consequence, bit, instant;
service: help, overhaul, avail;
result: upshot, outcome, termination, consequence, lead, solvent, event, solution;
field: area, champaign, battleground, domain, bailiwick, theatre, theater, arena;
heard: try, listen, see;
study: examine, take, meditate, analyse, cogitation, contemplate, canvass, bailiwick, read, work, analyze;
position: billet, view, lieu, set, status, stance, put, perspective, stead, lay, placement, emplacement, berth, attitude, side;
change: alteration, modify, vary, alter, modification, commute, deepen;
individual: somebody, private, soul, someone, mortal, person;
close: fold, confining, last, secretive, finale, finis, airless, end, stuffy, snug, tightlipped, conclude, nigh, cheeseparing, skinny, near, unaired, shut, faithful;
wanted: cherished, require, treasured, precious;
voice: articulation, part, interpreter, vocalism, vocalization, phonation, spokesperson, vocalisation;
company: troupe, caller, fellowship, society;
future: hereafter, next, succeeding;
provide: furnish, cater, ply;
effect: essence, upshot, outcome, consequence, gist, core;
stood: brook, tolerate, endure, fend, digest, bear, abide;
level: stratum, rase, storey, tier, dismantle, unwavering, tied, flat, raze;
control: ensure, curb, ascendency, ascendancy, verify, ascertain, insure, hold, manipulate, see, mastery, dominance, ascendance, ascendence;
total: entire, add, full, summate, sum, come, aggregate;
short: abruptly, curt, dead, curtly, suddenly, inadequate, myopic, little, forgetful, poor, unforesightful, unretentive, unawares, brusk, brusque, scant;
following: pursuit, pursue, accompany, espouse, next, comply, trace, succeed, surveil, come, be, chase, undermentioned, pursual, postdate;
evidence: tell, attest, show, grounds, demonstrate, certify, testify, manifest;
sound: go, legal, vocalize, effectual, phone, good, vocalise, intelligent, healthy, levelheaded, audio, wakeless, strait, fathom;
force: violence, pull, hale, ram, personnel, wedge, push, storm, impel, draw;
value: prise, appreciate, appraise, assess, esteem, treasure, rate;
leave: entrust, forget, parting, give, will, bequeath, depart, exit, farewell, impart;
surface: rise, airfoil, aerofoil, open, coat;
process: outgrowth, appendage, litigate, summons, work;
strong: impregnable, firm, inviolable, unattackable, unassailable, potent, warm, substantial, hard;
increase: gain;
started: commence, go, bulge, protrude, jump, originate, depart, pop, get;
minute: hour, mo, infinitesimal, bit, instant;
longer: yearner, farseeing, farsighted, tenacious, thirster, foresightful, prospicient, retentive, recollective, foresighted;
alone: exclusively, unique, unparalleled, solely, unequaled, solo, unaccompanied, only, entirely, unequalled;
mother: fuss, overprotect, engender, beget, sire, generate, get;
outside: alfresco, international, exterior, away, extraneous, external;
center: plaza, pore, marrow, halfway, kernel, meat, rivet, midpoint, mall, inwardness, snapper, eye, core, nub, gist, midway, essence, sum, pith;
expected: gestate, bear, ask, await, look, wait, require;
living: animation, go, sustenance, dwell, populate, endure, exist, life, survive, last, subsist, be, keep, know, inhabit;
pressure: blackjack, insistence, hale, coerce, insistency, imperativeness, blackmail;
ground: comminute, soil, moil, primer, grate, land, footing, cranch, bray, mash, fag, travail, craunch, toil, labour, undercoat, drudge, base, dig, priming, anchor, basis;
greater: outstanding, groovy, peachy, corking, dandy, keen, smashing, big, expectant, nifty, gravid, swell, majuscule, enceinte, bully;
required: necessitate, want, needed, ask, take, compulsory, mandatory, needful, postulate;
wrote: pen, save, indite, publish, compose;
moved: go, act, actuate, incite, impress, propel, displace, run, prompt, locomote;
modern: innovative, New;
condition: status, term, stipulate;
complete: pure, perfect, everlasting, thoroughgoing, nail, dispatch, over, terminated, ended, unadulterated, sodding, stark, arrant;
return: riposte, rejoinder, replication, comeback, repay, fall, devolve, take, payoff, regaining, takings, regress, pass, reelect, give, reappearance, generate, homecoming;
particular: especial, exceptional, item, finicky, fussy, picky, finical;
support: backing, endorse, reenforcement, back, backup, abide, livelihood, documentation, hold, keep, affirm, sustenance, tolerate, underpin, subscribe, endure, indorse, substantiate, patronize, patronise, brook, confirm, corroborate, accompaniment, reinforcement, funding, digest, bear;
attention: aid, care;
education: pedagogy, didactics, teaching;
material: substantial, fabric, corporeal, cloth;
stage: leg;
amount: sum, quantity;
followed: pursue, accompany, espouse, comply, trace, succeed, surveil, come, be, postdate;
added: contribute, bestow, summate, lend, sum, tally, impart, tot;
board: room, plank;
heart: tenderness, spunk, marrow, kernel, bosom, ticker, inwardness, centre, affectionateness, eye, pump, core, philia, warmness, mettle, nub, gist, essence, sum, pith, fondness, affection;
tried: essay, sample, seek, test, adjudicate, hear, attempt, assay, examine;
developed: modernise, rise, formulate, explicate, modernize, educate, uprise, grow, originate, germinate, recrudesce, get;
reached: hit, attain, accomplish, pass, gain, give, strive, hand, make;
feeling: palpate, notion, look, flavor, tone, flavour;
shown: indicate, designate, evince, usher, read, demo, testify, demonstrate, depict;
figure: anatomy, chassis, reckon, trope, name, bod, visualize, cypher, compute, form, envision, flesh, cipher, visualise, soma, forecast, see, calculate, physique, digit;
class: stratum, form, sort, category, year;
received: have, obtain, incur, invite, meet, find, get;
taking: necessitate, charter, ask, consume, deal, pack, fill, make, film, get, aim, lead, postulate, hold, require, have, subscribe, select, hire, withdraw, exact, rent, choose, read, need;
basic: introductory, canonical, staple;
inside: privileged, inwardly, within, indoors;
looking: bet, depend, reckon, await, face, attend, wait, calculate, seem, see;
trying: essay, sample, seek, test, adjudicate, hear, attempt, stressful, assay, examine;
picture: photo, flick, movie, show, characterisation, ikon, icon, visualise, envision, video, delineation, visualize, see, photograph, characterization, film;
spirit: feel, look, purport, flavor, life, intent, liveliness, tone, flavour;
beginning: commence, offset, rootage, commencement, root, showtime, kickoff, outset, get;
subject: case, capable, topic, open, bailiwick;
floor: coldcock, storey, deck, dump, base;
bring: contribute, play, fetch, wreak, take, bestow, institute, add, land, lend, work, impart, get;
simple: elementary, unproblematic, uncomplicated, childlike, bare, unsubdivided, mere;
range: roll, scope, vagabond, stove, swan, straddle, browse, roam, tramp, cast, ambit, pasture, rove, crop;
report: describe;
written: pen, save, indite, publish, compose;
natural: rude, raw, cancel, instinctive, born, lifelike, innate;
meeting: fulfill, fit, play, assemble, adjoin, forgather, satisfy, converge, fulfil, fill, confluence, foregather, see;
growth: ontogenesis, maturation, emergence, ontogeny, increment;
considered: view, reckon, take, deliberate, deal, believe, weigh, moot, see;
answer: respond, reply, suffice, solvent, do, solution;
working: knead, act, play, go, lick, ferment, form, turn, operative, solve, mould, cultivate, run, mold, exploit, sour, crop, make;
story: tale, narrative, narration, fib, tarradiddle, chronicle, taradiddle;
building: edifice, make;
table: shelve, prorogue, defer, postpone, mesa, remit;
training: civilise, aim, take, cultivate, educate, groom, civilize;
stand: brook, viewpoint, tolerate, pedestal, base, endure, rack, fend, digest, bear, abide;
issue: upshot, offspring, take, progeny, outlet, cut, payoff, outcome, takings, emergence, topic, consequence, egress, publication, publish, event, exit, emerge;
earlier: sooner, other, before, originally, former;
ready: set, make, cook, fix;
addition: plus, accession, improver;
statement: instruction, affirmation, assertion;
showed: indicate, designate, evince, read, demo, testify, demonstrate, depict;
start: commence, go, offset, bulge, commencement, protrude, showtime, jump, kickoff, originate, outset, pop, initiate, get;
thinking: mentation, conceive, cerebration, imagine, reckon, mean, believe, intelligent, intellection, cogitate, opine, intend, retrieve, cerebrate, suppose, recollect;
reading: recital, scan, take, show, understand, recitation, say, interpretation, indication;
color: distort, vividness, gloss, emblazon, semblance, tinge;
strength: forcefulness, specialty, persuasiveness, effectiveness, speciality, durability, forte, lastingness, potency, enduringness, intensity, metier;
appeared: seem, look;
record: immortalize, memorialise, disc, commemorate, show, disk, memorialize, platter, immortalise, book, tape;
trade: swap, merchandise, sell, deal, swop, barter;
continued: proceed, uphold, retain, remain, stay, keep;
direction: steering, guidance, management, way, focussing, counseling, counsel, counselling;
section: subdivision, part, department, segment;
using: expend, victimisation, utilise, victimization, employ, utilize, habituate, exploitation;
influence: regulate, work, mold, tempt;
opened: unfold, afford, give;
trouble: cark, fuss, discommode, disorder, difficulty, inconvenience, disturb, perturb, distract, pain, hassle, unhinge, disquiet, incommode, ail;
stopped: discontinue, quit, end, kibosh, terminate, intercept, barricade, halt, bar, cease;
piece: part, opus, assemble, bit, nibble, firearm, man, tack, while;
cause: suit, have, lawsuit, grounds, effort, stimulate, induce, get, do, make;
effective: efficacious, good;
worked: turn, act, play, go, lick, ferment, form, solve, mould, cultivate, run, mold, exploit, sour, crop, make;
provided: furnish, cater, ply;
wrong: improper, incorrectly, untimely, unseasonable, faulty, amiss, haywire, incorrect, awry;
average: mean, fair, modal, median, middling, intermediate, norm, mediocre;
defense: refutation, denial, vindication, DoD, demurrer;
placed: send, pose, invest, post, site, aim, set, localise, lay, put, situated, rank, localize, rate;
movement: bm, crusade, effort, motility, trend;
meaning: signification, pregnant, entail, significant, imply, significance, intend, signify;
carried: gestate, deport, post, transmit, take, acquit, persuade, sway, pack, stockpile, comport, run, dribble, hold, behave, bear, impart;
respect: prise, obedience, deference, esteem, honour;
direct: unmediated, channelize, aim, lead, verbatim, orchestrate, engineer, channelise, send, manoeuver, maneuver, manoeuvre, head, take, organise, steer, mastermind, calculate, lineal;
plant: embed, flora, imbed, set, institute, engraft, constitute, works;
approach: near, feeler, overture;
larger: bombastic, big, prominent, orotund, expectant, gravid, magnanimous, declamatory, enceinte, tumid, turgid;
couple: mates, dyad, duo, duet, distich, pair, twain, twosome, brace, yoke, mate, twin, span, duad;
charge: buck, guardianship, bill, accusation, boot, bang, tutelage, kick, rush, cathexis, commove, tear, billing, institutionalize, burster, agitate, send, load, accuse, consign, institutionalise, appoint, excite, complaint, thrill, rouse, file, mission;
court: solicit, woo, judicature, tribunal, homage;
remember: retrieve, commemorate, commend, recollect;
reported: describe;
served: help, assist, dish, attend, suffice, do;
understanding: apprehension, sympathize, realise, discernment, intellect, empathize, savvy, empathise, sympathy, read, infer, sympathise, see;
determined: fix, ascertain, set, regulate, mold, compulsive, find, dictated, see;
trial: visitation, run, test, tryout;
appear: seem, look;
image: epitome, trope, ikon, icon, persona, simulacrum, effigy, visualise, envision, visualize, see, prototype, paradigm;
account: invoice, bill, describe, explanation, chronicle, history;
character: role, part, case, fibre, persona, eccentric, type, fiber, grapheme, lineament;
learned: knowledgeable, teach, take, con, ascertain, memorise, erudite, instruct, memorize, see;
earth: land, globe;
technical: proficient, expert;
planning: contrive;
volume: loudness, bulk, intensity, mass, book;
returned: riposte, rejoin, repay, fall, devolve, revert, pass, reelect, give, generate;
forward: advancing;
lived: go, dwell, populate, endure, exist, subsist, last, be, know, inhabit;
serious: unplayful, good;
function: role, part, affair, subprogram, mapping, go, map, officiate, run, purpose, subroutine, work, use, procedure;
saying: aver, enjoin, enounce, allege, locution, articulate, enunciate, tell, read, suppose, pronounce;
corner: nook, recession, recess, quoin, box, niche, tree;
straight: directly, true, unbowed, uncoiled, flat, neat, consecutive, heterosexual, unbent;
plane: skim, flat, shave;
quality: choice, timbre, select, calibre, caliber, timber, tone, lineament;
writing: pen, penning, authorship, save, indite, publish, compose;
square: lame, satisfying, substantial, straightforward, hearty;
pattern: convention, form, rule, blueprint, normal;
horse: cavalry, buck, knight, sawbuck;
organization: governance;
moving: go, act, proceed, actuate, incite, motivate, impress, propel, displace, run, prompt, locomote;
visit: sojourn, jaw, impose, claver, confab, chat, chaffer, chitchat, confabulate, see, chatter, natter, gossip, call;
progress: advancement;
design: excogitation, contrive, intention, innovation, conception, aim, blueprint, plan, intent, invention, purpose;
distance: outstrip, aloofness, length;
established: shew, naturalized, show, institute, base, give, constituted, instal, launch, install, constitute, demonstrate, make;
expect: gestate, bear, ask, await, look, wait, require;
principle: rule, precept;
stress: emphasis, emphasize, punctuate, try, emphasise, accent, accentuate;
operation: procedure, surgery;
designed: contrive, intentional, plan;
consider: view, reckon, take, deliberate, deal, believe, weigh, moot, see;
ahead: onwards, forwards, forrader, before, onward, beforehand;
growing: turn, ontogenesis, maturation, rise, maturate, farm, ontogeny, uprise, originate, get;
applied: utilise, implement, give, employ, hold, utilize, use, enforce;
language: words, nomenclature, terminology, lyric;
continue: proceed, uphold, retain, remain, stay, keep;
season: flavor, flavour, mollify, harden;
write: publish, compose, save, pen;
reach: hit, scope, attain, accomplish, ambit, gain, pass, give, strive, hand, make;
covered: incubate, encompass, enshroud, plow, hatch, compensate, deal, insure, underwrite, overcompensate, brood, hide, shroud;
union: coupling, North, conglutination, wedlock, pairing, matrimony, sum, brotherhood, join, mating, jointure, marriage;
closed: unsympathetic, fold, unopen, conclude, shut;
administration: disposal, presidency, government, judicature, governance;
serve: help, assist, dish, attend, suffice, do;
attack: aggress, flak, onset, attempt, snipe, assail, onrush, fire, onslaught;
staff: faculty;
element: constituent, ingredient;
mouth: backtalk, sassing, sass, talk, speak, verbalize, verbalise, lip;
played: act, fiddle, wager, spiel, diddle, flirt, work, wreak, bet, run, recreate, dally, toy, trifle, meet;
limited: define, restrict, fix, set, restrain, confine, throttle, trammel, circumscribe;
prepared: devise, fain, fix, organise, set, machinate, educate, groom, cook, make;
original: archetype;
reason: intellect, grounds, argue, conclude, rationality;
factor: constituent, cistron, gene, component, divisor, broker, ingredient;
scene: fit, vista, view, aspect, shot, tantrum, conniption, panorama;
teeth: dentition;
raised: kindle, evoke, enhance, rear, upgrade, recruit, provoke, levy, grow, elevate, nurture, enkindle, embossed, leaven, farm, stir, heighten, invoke, elicit, conjure, promote, parent, erect, fire, resurrect, lift;
demand: necessitate, ask, take, exact, require, postulate, need, requirement;
professional: pro;
dropped: fell, flatten, expend, dismiss, miss, degenerate, pretermit, shed, dangle, overlook, devolve, deteriorate, overleap, cast, omit, dribble, sink, unload;
playing: act, fiddle, wager, spiel, diddle, flirt, work, wreak, bet, performing, run, recreate, dally, toy, trifle, meet;
built: reinforced, make;
meant: imply, intend, signify;
filled: take, satiate, satisfy, replete, sate, meet;
talking: blab, spill, speak, babble, peach, verbalize, lecture, tattle, verbalise;
related: link, connect, pertain;
entered: participate, inscribe, recruit, enroll, infix, accede, embark;
machine: motorcar, automobile, car, auto;
march: abut, parade, adjoin, borderland, butt, edge, demonstrate;
fight: competitiveness, contend, crusade, push, combat, agitate, press, battle, scrap;
concern: care, headache, pertain, vexation, fear, relate;
caught: view, overtake, hitch, overhear, entrance, captivate, fascinate, beguile, enchant, bewitch, trance, enamour, see, grab, becharm, enamor, get;
claim: take, exact, arrogate, call;
supply: furnish, cater, append, add;
style: mode, vogue, dash, way, panache, elan, fashion, manner, trend, flair;
standing: brook, tolerate, endure, fend, digest, bear, abide;
changed: modify, vary, alter, commute, deepen;
share: part, contribution, apportion, deal, percentage;
product: ware, merchandise;
accepted: recognised, have, take, consent, bear, swallow;
opinion: sentiment, judgement, view, persuasion;
primary: elementary, chief, elemental, main, basal;
relation: congress, intercourse, coitus;
older: aged, erstwhile, onetime, senior, previous, sometime;
station: send, post;
drive: repulse, crusade, tug, labour, aim, take, ram, effort, push, parkway, repel, motor, get;
practice: use, do, recitation, rehearse;
giving: openhanded, dedicate, open, make, contribute, feed, pass, hold, afford, generate, pay, have, bighearted, bountiful, gift, handsome, freehanded, impart, devote, bounteous, big, collapse, consecrate, hand;
standard: touchstone, banner, criterion;
determine: fix, ascertain, set, regulate, mold, find, see;
sitting: seance, pose, ride, session, seat;
middle: halfway, centre, mediate, eye, midriff;
project: contrive, jut, plan, undertaking, visualise, envision, cast, externalise, task, visualize, externalize, see;
objective: aim, documentary;
produced: get, farm, grow, make;
follow: pursue, accompany, espouse, comply, trace, succeed, surveil, come, be, postdate;
source: generator, seed, informant, rootage, root, reservoir, author, germ;
balance: equilibrium, equaliser, equipoise, symmetry, remainder, proportionality, equilibrize, residue, poise, counterweight, residual, Libra, equilibrate, correspondence, equalizer, equilibrise, counterpoise, rest, residuum, symmetricalness;
weight: slant, burthen;
noted: illustrious, remark, famous, celebrated, mark, famed;
regard: view, reckon, gaze, wish, heed, compliments, esteem, attentiveness, see;
principal: head, corpus, chief, lead, main, dealer, star;
equal: compeer, be, rival, peer;
develop: modernise, rise, evolve, formulate, explicate, modernize, educate, uprise, grow, originate, germinate, recrudesce, get;
measure: step, cadence, quantify, criterion, bill, valuate, appraise, quantity, touchstone, assess, bar, beat;
spoke: rundle, talk, rung, radius, verbalize, verbalise;
association: tie, connexion;
allowed: tolerate, let, countenance, appropriate, earmark;
touch: signature, speck, trace, jot, relate, allude, advert, rival, disturb, tinct, mite, hint, tint, pertain, stir, meet, pinch, partake, adjoin, spot, tinge, ghost;
break: go, part, bankrupt, fracture, disclose, erupt, demote, wear, infract, respite, fail, transgress, recrudesce, soften, gap, intermission, give, relegate, unwrap, dampen, ruin, discontinue, pause, disruption, expose, intermit, recess, divulge, bump, rupture, smash, offend, die, interrupt, bust, stop, collapse, violate, severance, rift, interruption, damp;
finished: stop, cease, end, terminate;
marked: nock, tag, stigmatise, pit, differentiate, tick, commemorate, scar, pock, denounce, set, punctuate, stigmatize, pronounced, note, distinguish;
failure: nonstarter, loser, bankruptcy;
cover: incubate, masking, encompass, enshroud, deal, comprehend, back, plow, insure, underwrite, brood, traverse, top, shroud, concealment, hatch, overcompensate, compensate, hide;
build: anatomy, form, chassis, soma, physique, flesh, make;
greatest: outstanding, groovy, peachy, sterling, dandy, keen, smashing, big, expectant, nifty, enceinte, gravid, swell, majuscule, bully, superlative, corking;
variety: smorgasbord, assortment, form, motley, mixture, kind, diverseness, sort, miscellany, potpourri, miscellanea, salmagundi, multifariousness;
remains: corpse, persist, cadaver, stay, clay;
appears: seem, look;
offered: bid, propose;
authority: confidence, bureau, sureness, potency, agency, assurance, dominance;
learn: teach, take, con, ascertain, memorise, instruct, memorize, read, see;
shape: conformation, form, anatomy, chassis, mould, configuration, regulate, soma, embodiment, cast, mold, bod, forge, physique, work, contour, flesh;
bridge: nosepiece, span;
remembered: retrieve, commemorate, commend, recollect;
sight: lot, view, mess, flock, deal, wad, peck, muckle, stack, raft, slew, mickle, heap, mountain, mint, spate, pile, pot, hatful, plenty, mass, ken, vision, batch, spy, passel;
begin: commence, get;
produce: get, farm, grow, make;
named: distinguish, advert, describe, cite, key, diagnose, call, list, nominate, constitute, appoint, make;
circumstance: context;
presented: portray, pose, show, face, salute, give, gift, introduce, demo, award, confront, demonstrate, acquaint;
active: dynamic, participating;
opening: possibility, gap, orifice, hatchway, initiative, unfold, porta, give, afford, scuttle;
dance: saltation, terpsichore;
broad: panoptic, extensive, unsubtle, encompassing, full, tolerant, unspecific, wide, spacious;
operating: go, manoeuvre, mesh, run, lock, work, manoeuver, maneuver;
agreed: fit, harmonize, concord, correspond, jibe, gibe, harmonise, hold, concur, consort, tally;
essential: indispensable, requisite, crucial, necessary, requirement, necessity;
fixed: rigid, unsex, restore, mend, desexualize, bushel, set, desex, deposit, fasten, situate, desexualise, get, posit, sterilise, sterilize, cook, make;
provides: furnish, cater, ply;
created: make;
watched: ascertain, view, see;
campaign: safari, crusade, effort, push, run, agitate, press;
speed: quicken, race, rush, fastness, hasten, hie, amphetamine, swiftness, zip, accelerate, velocity, hotfoot;
recognized: distinguish, accredit, greet, discern, spot, realise, know;
leaving: entrust, forget, departure, give, will, bequeath, depart, exit, impart;
agreement: correspondence, concord, accord;
feature: boast, lineament, characteristic, have;
studied: examine, take, meditate, analyse, contemplate, canvass, read, analyze;
offer: go, bid, pass, propose, whirl, fling;
forced: pull, hale, ram, wedge, push, storm, constrained, impel, draw;
atmosphere: ambiance, atm, air, ambience, aura;
regular: even, veritable, unconstipated, fixture, habitue;
desire: want, hope;
spread: disperse, unfold, open, feast, gap, counterpane, bedcover, diffuse, scatter, propagate, circulate, paste, disseminate, distribute, circularize, broadcast, banquet, ranch, circularise;
drink: tope, fuddle, crapulence, imbibe, potable, boozing, beverage, pledge, salute, booze, wassail, swallow, deglutition;
expression: aspect, face, look, formulation, locution, verbalism, manifestation;
enter: participate, inscribe, infix, recruit, introduce, accede, embark;
opposite: polar, paired, diametric, diametrical, inverse, antonym;
picked: cull, nibble, plunk, beak, foot;
reduced: shorten, subdue, trim, shrink, thin, abbreviate, slenderize, subjugate, slim, abridge, quash, cut, tighten, decoct, dilute, deoxidize, repress, deoxidise, foreshorten;
favor: prefer, privilege;
secret: arcanum, mystery, undercover, confidential, mystical, private, occult, clandestine, unavowed, privy, enigma, orphic, surreptitious, mysterious, mystic;
bright: brilliantly, shiny, hopeful, undimmed, vivid, lustrous;
train: civilise, take, cultivate, educate, groom, gear, civilize;
smaller: lowly, belittled, little, minor, low, minuscule;
receive: have, obtain, incur, invite, meet, find, get;
commission: delegacy, perpetration, delegation, deputation;
separate: distinguish, classify, differentiate, dissever, freestanding, disjoined, secern, ramify, tell, assort, disunite, offprint, fork;
address: destination, plow, accost, deal, speak, call;
response: reply;
watch: spotter, vigil, view, sentry, lookout, scout, picket, ascertain, ticker, sentinel, see;
formed: imprint, organise, mould, mold, work, constitute, make;
follows: pursue, accompany, espouse, comply, trace, succeed, surveil, come, be, postdate;
index: exponent, indicator, forefinger, indicant;
fresh: reinvigorated, wise, unfermented, invigorated, unused, overbold, new, newly, saucy, bracing, sassy, impudent, brisk, impertinent, novel, tonic;
permit: tolerate, licence, license, let, countenance;
hearing: audition, listen, try, earshot, audience, earreach, see;
treated: plow, deal;
killed: obliterate, defeat, down, pop;
stayed: appease, bide, rest, quell, detain, persist, remain, outride, abide;
removed: withdraw, hit, distant, absent, take, slay, murder, dispatch, off;
presence: comportment, mien;
pointed: channelise, maneuver, manoeuvre, head, sharpen, aim, taper, show, betoken, steer, bespeak, luff, channelize, manoeuver;
quiet: repose, lull, tranquillise, tranquillity, tranquil, serenity, hushed, placidity, tranquillize, muted, calm, subdued, hush, placid, unruffled;
security: certificate;
check: stoppage, substantiation, hitch, tab, confirmation, handicap, tally, hinderance, halt, insure, stay, hold, impediment, verification, chip, curb, tick, deterrent, mark, balk, correspond, jibe, retard, gibe, see, fit, ensure, chit, bridle, baulk, ascertain, stop, hindrance, assay;
expressed: verbalized, evince, show, extract, verbalize, explicit, verbalise;
failed: go, bomb, die, miscarry, flunk, betray;
watching: view, ascertain, observation, observance, see;
seeing: view, reckon, look, understand, construe, visualize, realise, examine, date, sightedness, hear, envision, attend, insure, visualise, escort, meet, find, ensure;
observed: remark, detect, celebrate, keep, note, find, honour;
frame: anatomy, chassis, couch, skeleton, entrap, soma, ensnare, redact, cast, bod, put, physique, inning, compose, flesh;
discovered: distinguish, expose, divulge, attain, hear, detect, key, name, reveal, unwrap, find, see;
pulled: pluck, draw, deplumate, displume, tear, rend, extract, deplume, perpetrate, rive, rip, attract, overstretch;
youth: juvenility;
contrast: demarcation, line;
official: functionary, prescribed;
positive: prescribed, irrefutable, confident, confirming, convinced, incontrovertible, cocksure, overconfident, plus;
planned: contrive, aforethought;
assumed: usurp, fictitious, sham, don, take, seize, pretended, arrogate, fictive, simulate, wear, bear, feign;
store: shop, fund, memory, entrepot, depot;
familiar: comrade, companion, conversant;
accept: have, take, consent, bear, swallow;
chosen: prefer, opt, take, select, elect;
proved: essay, shew, rise, show, try, test, leaven, testify, demonstrate, examine;
broke: go, part, bankrupt, disclose, fracture, erupt, demote, wear, infract, fail, recrudesce, transgress, soften, give, relegate, unwrap, dampen, ruin, discontinue, expose, pause, intermit, bump, divulge, smash, weaken, skint, offend, die, interrupt, bust, stop, collapse, violate, reveal, damp;
detail: item, contingent;
brief: abbreviated;
allow: tolerate, let, countenance, appropriate, earmark;
round: turn, circular, labialise, snipe, rhythm, troll, bout, assail, stave, labialize, beat;
sharp: piercing, penetrative, acuate, tart, precipitous, knifelike, keen, incisive, astute, acutely, crisp, discriminating, needlelike;
carrying: gestate, deport, post, transmit, take, acquit, persuade, sway, pack, stockpile, comport, run, dribble, hold, behave, bear, impart;
solid: firm, satisfying, substantial, upstanding, unanimous, hearty;
realize: earn, understand, substantiate, gain, agnise, make, see;
willing: unforced, bequeath, volition, uncoerced;
ordered: ordain, arrange, regularize, dictate, regulate, enjoin, put, consecrate, rank, logical, say, tell, regularise, consistent, prescribe, govern, rate;
realized: earn, understand, substantiate, gain, actualise, agnise, recognise, make, see;
connection: link;
completed: dispatch, nail, realised;
settled: subside, decide, fall, reconcile, adjudicate, root, finalise, colonised, finalize, colonized, locate, descend, conciliate, sink, ensconce;
drawn: eviscerate, haggard, describe, line, trace, cast, worn, tie, get, make, pull, delineate, pass, puff, reap, disembowel, attract, raddled, imbibe, suck, careworn, depict;
sweet: mellisonant, honeyed, odorous, unfermented, afters, angelical, seraphic, dulcet, sugariness, mellifluous, odoriferous, gratifying, confection, sugared, perfumed, angelic, cherubic;
asking: necessitate, enquire, take, request, need, inquire, postulate, require;
answered: suffice, do, respond, reply;
thick: boneheaded, chummy, heavyset, duncish, loggerheaded, blockheaded, midst, dense, duncical, fatheaded, slurred, deep;
directed: channelise, send, manoeuvre, head, take, aim, organise, steer, channelize, mastermind, calculate, lead, orchestrate, manoeuver, maneuver, engineer;
declared: adjudge, announce, stated, hold;
helped: avail, aid, assist, facilitate;
independent: autonomous, fencesitter, mugwump, freelancer, freelance, main, sovereign;
reference: denotation, cite, citation, quotation, consultation, acknowledgment;
division: part, partition, sectionalisation, variance, segmentation, sectionalization, partitioning;
quick: speedy, immediate, promptly, warm, fast, spry, prompt, nimble, straightaway, agile;
weather: conditions, endure, upwind;
block: stoppage, pulley, impede, obturate, occlusion, jam, closure, cube, freeze, barricade, halt, stymy, obstruct, occlude, deflect, bar, lug, immobilise, parry, hinder, forget, stymie, immobilize, stop, kibosh, embarrass;
relief: easement, rest, alleviation, easing, ministration, embossment, succor, succour, moderation, backup, assuagement, ease;
background: desktop, downplay, scope;
phase: form;
dress: apparel, garb, arrange, snip, set, trim, enclothe, clip, attire, preen, garnish, plume, frock, primp, groom, clothes, prune, curry, coiffure, crop, garment, clothe, lop, habilitate, decorate, coiffe, coif, do, raiment, tog;
impact: encroachment, wallop, impingement;
chair: professorship, lead;
finger: feel, thumb, digit;
leading: contribute, go, take, conduce, preeminent, precede, stellar, run, pass, prima, top, star;
search: seek, lookup, look, explore, hunt;
supposed: speculate, conjectural, divinatory, reckon, imagine, conjecture, theorize, hypothetic, hypothetical, alleged, hypothesise, theorise, opine, say, hypothesize, hypothecate;
measured: quantify, metric, deliberate, careful, appraise, valuate, assess, metrical;
application: diligence;
clean: plum, uninfected, unobjectionable, pick, sportsmanlike, fairly, sporty, fair, plumb, unclouded, neat, uncontaminating, scavenge;
object: aim;
wonder: enquire, marvel, admiration, curiosity, inquire;
protection: aegis, tribute, auspices;
empty: vacuous, vacate, evacuate, void;
birth: have, nativity, parentage, nascency, bear, nascence, parturition;
fighting: contend, crusade, push, combat, agitate, press, scrap;
model: manakin, simulation, mannequin, pose, exemplary, exemplar, framework, mannikin, simulate, manikin, sit, poser;
argument: tilt, contestation, line, disceptation, contention, disputation, controversy;
broken: go, part, bankrupt, humiliated, disclose, fracture, erupt, demote, impoverished, wear, infract, fail, recrudesce, transgress, unkept, give, relegate, unwrap, dampen, ruin, discontinue, expose, pause, intermit, bump, divulge, low, busted, smash, humbled, die, interrupt, bust, stop, collapse, violate, reveal, rugged, disordered, damp;
holding: retention, retain, make, bind, harbour, obtain, entertain, halt, give, deem, declare, keep, defy, concur, property, withstand, curb, have, belongings, concord, confine, book, adjudge, take, restrain, prevail, bear;
sleep: sopor, rest, kip, nap;
portion: constituent, lot, component, parcel, luck, destiny, dower, allot, percentage, dowry, fate, circumstances, dowery;
resolution: firmness, closure, solvent;
passing: choke, go, fade, elapse, lapse, croak, cursory, departure, hap, evanesce, authorise, perish, occur, excrete, overtake, expire, exceedingly, give, loss, run, lead, expiration, transitory, top, draw, overtaking, transcend, perfunctory, spend, egest, overhaul, authorize, exceed, fleet, overstep, super, extremely, happen, die, fall, devolve, legislate, conk, ephemeral, decease, fugacious, exit, hand;
honor: accolade, pureness, purity, laurels, award;
fellow: blighter, cuss, beau, companion, dude, confrere, boyfriend, chap, buster, gent, lad, comrade, mate, bloke, swain, colleague;
struggle: sputter, contend, shin, clamber, skin, battle, shinny;
cutting: veer, shorten, slue, trim, bleak, swerve, ignore, abbreviate, burn, skip, disregard, snub, slip, abridge, edit, prune, rationalise, slew, lancinate, dilute, rationalize, hack, tailor, knifelike, keen, edged, raw, geld, foreshorten, trend;
drove: repulse, tug, swarm, labour, aim, take, ram, push, ride, horde, motor, repel, get;
powerful: hefty, potent, sinewy, mightily, mighty, brawny, herculean, muscular;
assignment: naming, designation;
highest: gamey, eminent, gamy, mellow;
recognize: distinguish, greet, discern, spot, accredit, know;
turning: bend, ferment, rick, plow, deform, become, wrick, wrench, flex, work, plough, sour, sprain, grow;
assume: usurp, sham, don, take, seize, arrogate, simulate, wear, bear, feign;
price: cost, toll, terms;
starting: commence, go, bulge, protrude, jump, originate, depart, pop, initiate, get;
speech: words, lecture;
showing: indicate, designate, evince, usher, read, demo, testify, demonstrate, depict;
liberal: free, bounteous, openhanded, big, bighearted, bountiful, handsome, freehanded;
escape: miss, lam, leak, outflow, evasion, dodging, leakage, elude, run, bunk;
master: overlord, overcome, captain, subdue, chief, victor, skipper, passkey, main, lord, surmount;
narrow: constringe, specialise, specialize, constrict;
learning: teach, eruditeness, take, con, acquisition, erudition, encyclopedism, encyclopaedism, memorise, ascertain, instruct, memorize, read, scholarship, see;
rising: rear, insurrection, heighten, acclivitous, uphill, revolt, wax, rebel, jump, ascent, grow, rebellion, ascension, ascend, resurrect, lift;
closer: tightlipped, near, airless, stuffy, finisher, unaired, snug, confining, nigh, nigher, cheeseparing, secretive, skinny, faithful;
traffic: dealings;
refused: defy, deny;
column: editorial, tower, pillar;
contained: curb, incorporate, take, stop, comprise, hold, bear;
maintain: assert, exert, uphold, asseverate, hold, keep, conserve, wield;
extreme: uttermost, utmost;
dream: aspiration, ambition, woolgather, stargaze;
heavily: hard, intemperately;
setting: define, pose, arrange, typeset, countersink, context, scope, put, adjust, coiffure, congeal, jell, mark, rig, localise, fructify, fix, sic, lay, coif, do, localize, coiffe;
score: nock, hit, grievance, mark, seduce, grudge, make, tally;
headed: channelise, maneuver, manoeuvre, steer, channelize, manoeuver;
sensitive: raw, sore, spiritualist;
conclusion: finis, end, determination, termination, ratiocination, last, finale;
contract: undertake, compress, condense, shorten, take, cut, sign, shrink, abridge, foreshorten, abbreviate, press, get;
struck: coin, hit, move, fall, scratch, take, impress, expunge, attain, mint, shine, smitten, excise;
shoulder: berm;
exchange: replace, central, commute, commutation, substitution;
establish: shew, show, institute, base, give, launch, constitute, demonstrate, make;
talked: blab, spill, sing, speak, peach, verbalize, lecture, verbalise;
formula: convention, recipe;
judgment: mind, sagaciousness, assessment, perspicacity, sagacity;
understood: sympathize, empathize, empathise, realise, read, tacit, infer, sympathise, see;
command: bid, bidding, overlook, dictation, instruction, overtop, require, mastery, dominate;
occasion: affair, juncture;
appeal: entreaty, prayer, attract, ingathering, solicitation, collection, invoke;
liked: care, wish;
exercise: usage, workout, employment, work, utilization, recitation, utilisation, do, use;
circle: roofy, rope, lot, roundabout, set, rotary, rophy, band, lap, roach;
charged: buck, send, load, rouse, commove, bill, tear, accuse, consign, excite, institutionalize, file, institutionalise, appoint, agitate;
keeping: proceed, guardianship, save, prevent, retention, celebrate, retain, restrain, hold;
aside: divagation, away, by, parenthesis, excursus, digression;
taste: savour, sample, discernment, try, savor, mouthful, smack, penchant, perceptiveness, appreciation, gustation, preference, predilection;
contact: middleman, adjoin, liaison, tangency, meet, link, impinging;
appearance: show;
continuing: proceed, chronic, uphold, retain, remain, stay, keep;
alive: awake, animated;
shook: rock, sway, stimulate, stir, excite, agitate, judder, didder;
providing: furnish, cater, ply;
tension: tautness;
advance: elevate, improvement, betterment, procession, rise, encourage, upgrade, feeler, promote, beforehand, gain, overture, win, progression, supercharge, further;
repeated: recur, echo, recurrent, ingeminate, duplicate, perennial;
apply: utilise, implement, give, hold, utilize, use, enforce;
organized: devise, form, machinate, mastermind, unionise, unionised, orchestrate, engineer;
represented: act, play, delineated, symbolize, typify, map, delineate, be, comprise, symbolise, constitute, exemplify;
signal: indicate, bespeak, betoken;
becoming: turn, go, suit, decorous, comely, seemly, get;
culture: civilisation, cultivation, refinement, civilization;
conducted: deport, acquit, take, transmit, deal, lead, comport, behave, bear, impart;
notice: card, remark, bill, placard, detect, mark, posting, observation, find, observance;
sought: essay, seek, try, attempt, assay;
credit: citation, quotation, acknowledgment;
joined: link, connect;
extended: go, exsert, prolong, lengthened, prolonged, protracted, gallop, elongated, protract, widen, broaden, unfold, run, pass, lead, lengthy;
scale: scurf, exfoliation, surmount;
critical: decisive;
theme: topic, idea, root, base;
travel: go, move, locomotion, trip, jaunt, journey, locomote;
wished: bid, like, care;
supported: patronise, brook, confirm, tolerate, corroborate, underpin, subscribe, endorse, endure, indorse, substantiate, back, digest, patronize, hold, bear, abide, affirm;
worry: care, vex, vexation, headache;
divided: dissever, part, fraction;
wheel: pedal, bicycle, roll, rack, bike;
double: bivalent, reduplicate, twofold, twice, forked, threefold, replicate;
trained: civilise, aim, cultivate, educate, groom, civilize;
motion: gesticulate, move, gesture;
experienced: have, live, feel, see, know, get;
granted: accord, concede, give, award, cede, allot;
largest: bombastic, big, prominent, orotund, expectant, gravid, magnanimous, declamatory, enceinte, tumid, turgid;
pushed: advertize, labour, tug, crusade, advertise, promote, agitate, press;
prove: essay, shew, rise, show, try, test, leaven, testify, demonstrate, examine;
negative: disconfirming, damaging, blackball, veto, minus;
assigned: attribute, delegate, arrogate, put, depute, impute, allot;
conduct: behaviour, demeanor, demeanour, deportment, deport, doings, acquit, take, transmit, deal, lead, comport, behave, bear, behavior, impart;
loose: free, slack, easy, informal, idle, promiscuous, lax, wanton, open, unleash, sluttish, unaffixed, liberate;
generation: coevals, contemporaries, multiplication;
create: make;
inner: privileged;
depth: astuteness, profundity, deepness, profoundness;
title: deed, championship, rubric;
establishment: ecesis, validation, constitution, institution, organisation, governance;
crowd: bunch, herd, push, gang;
introduced: innovate, preface, inclose, infix, precede, premise, enclose, inaugurate, acquaint;
bitter: acerb, piercingly, vitriolic, sulfurous, bitingly, caustic, acrid, acid, acerbic, sulphurous, acrimonious, virulent;
grass: weed, forage, pasturage, sess, shop, shit, eatage, denounce, stag, betray, gage, pot, pasture, sens, snitch, locoweed, skunk, dope;
troop: promenade, flock, parade;
acting: play, dissemble, pretend, move, work, performing, roleplay, behave, do, playact;
yellow: chicken, jaundiced, xanthous, scandalmongering, chickenhearted, sensationalistic, icteric;
guess: supposition, pretend, surmisal, reckon, conjecture, imagine, approximate, surmise, shot, speculation, hypothesis, opine, infer, suppose;
content: message;
conflict: dispute, contravene, infringe, difference, battle;
handle: care, plow, deal, grip, hold, palm, wield;
correct: chastise, objurgate, slump, counterbalance, redress, set, compensate, adjust, chasten, castigate;
stream: flow, current, pelt, watercourse, pullulate, pour;
raise: kindle, evoke, hike, enhance, rear, recruit, provoke, heave, levy, grow, elevate, nurture, enkindle, leaven, farm, stir, heighten, invoke, elicit, conjure, promote, acclivity, parent, erect, fire, resurrect, lift;
driving: impulsive, repulse, tug, labour, aim, take, ram, push, ride, motor, repel, get;
developing: modernise, rise, evolve, formulate, explicate, modernize, educate, uprise, grow, originate, germinate, recrudesce, get;
agree: fit, harmonize, accord, concord, correspond, jibe, gibe, harmonise, hold, concur, consort, tally;
telling: narrate, cogent, weighty, recount, differentiate, severalise, impressive, apprisal, enjoin, notification, say, secern, recite, recounting, secernate, distinguish, severalize, tattle;
advanced: elevate, encourage, upgrade, innovative, promote, gain, win, ripe, supercharge, further;
begun: commence, get;
putting: pose, invest, arrange, couch, set, lay, cast, redact;
angle: tilt, tip, fish, slant, lean;
mention: advert, remark, cite, name, acknowledgment, note;
remove: withdraw, hit, absent, take, slay, murder, dispatch, off;
faced: confront, look;
extra: additional, excess, surplus, supernumerary, supererogatory, duplicate, superfluous, redundant;
surprise: storm;
brilliant: magnificent, glorious, splendid, vivid, superb;
uniform: consistent, unvarying, undifferentiated;
easier: comfortable, leisurely, prosperous, soft, wanton, promiscuous, sluttish;
conventional: ceremonious, schematic;
trust: hope, cartel, reliance, faith, believe, confidence, rely, bank, confide, swear;
silent: soundless, mute, mum, unsounded, tacit, dumb;
consideration: thoughtfulness, retainer;
passage: enactment;
hoped: skip;
chain: concatenation, strand;
operate: go, manoeuvre, mesh, run, lock, work, manoeuver, maneuver;
speaking: talk, verbalise, verbalize;
acceptance: espousal, toleration, adoption;
worse: bad, unsound, big, sorry, unfit, spoilt, risky, speculative, defective, uncollectible, regretful, spoiled;
tired: exhaust, commonplace, outwear, pall, fag, sap, timeworn, bore, hackneyed, wear, weary, banal, jade, shopworn;
finding: happen, rule, obtain, determination, bump, ascertain, regain, feel, detect, incur, get, retrieve, see;
formal: stately, schematic, courtly, ball;
rolled: twine, pluck, wind, undulate, vagabond, swan, wrap, roam, seethe, hustle, wander, tramp, cast, flap, involute, wave;
swung: dangle, drop, sway;
maintained: assert, exert, uphold, asseverate, hold, keep, conserve, wield;
denied: abnegate, traverse;
limit: define, boundary, restrict, fix, set, restrain, demarcation, confine, throttle, trammel, circumscribe;
apart: asunder;
screen: filmdom, riddle, concealment, sort, test, shield, covert;
shooting: hit, scud, buck, dash, sprout, spud, film, bourgeon, tear, dart, germinate, fool, dissipate, inject, pip, photograph, snap, take, fritter, pullulate;
concentration: engrossment, assiduity, tightness, assiduousness, denseness, compactness, density, immersion;
burning: combustion, combust, electrocution, bite, cut, cauterize, cauterise, glow, fire, incinerate;
plain: kvetch, unpatterned, manifest, apparently, kick, obviously, unmixed, manifestly, patently, homely, apparent, evidently, unmistakable, unembellished, unornamented, unmingled, unvarnished, quetch, evident, bare, knit;
version: interpretation, adaptation;
silence: quieten, hush, muteness;
drinking: tope, fuddle, imbibe, crapulence, boozing, pledge, salute, booze, wassail, imbibition;
liquid: melted, fluent;
creation: existence, institution, macrocosm, universe, cosmos;
review: retrospect, revaluation, critique, recapitulation, brushup, inspection, reappraisal, reassessment, reexamination, refresh, reexamine, followup, recap;
engaged: booked, intermeshed, enlist, pursue, betroth, affiance, plight, charter, take, busy, lock, mesh, hire, prosecute, employ, rent, meshed, engross;
identified: name, describe, distinguish, key;
threw: drop, confound, bedevil, cast, discombobulate, bemuse, make, shed, give, hold, flip, contrive, fox, befuddle, hurl, have, bewilder, fuddle, confuse;
blind: subterfuge, unsighted, dim, unreasoning;
interior: DoI, midland, upcountry, home;
mantle: pall, curtain, cape, pallium, drapery, drape, chimneypiece;
humor: wit, wittiness, witticism, mood;
minister: pastor, parson, curate, rector;
strike: coin, hit, tap, move, smasher, fall, scratch, impress, expunge, rap, bang, attain, mint, smash, excise;
resistance: immunity;
wearing: fag, bust, endure, tire, don, jade;
civil: polite;
contrary: wayward, adverse, obstinate, perverse;
promise: hope, foretell, predict, forebode, call;
opposition: foeman, foe, enemy;
adopted: espouse, take, dramatise, dramatize, borrow;
sheet: rag, tabloid, canvass, sail, shroud, tack;
impression: stamp, notion;
referred: denote, advert, consult, pertain, cite, name, relate;
safety: prophylactic, condom, refuge;
honest: true, reliable, good, fair, dependable;
native: aborigine, indigen, aboriginal, indigene;
containing: curb, incorporate, take, stop, comprise, hold, bear;
target: aim, quarry, mark, butt, prey;
sport: summercater, play, boast, romp, lark, mutation, rollick, fun, skylark, gambol, mutant, frolic, athletics, frisk;
intended: signify, destine, mean, designate;
panel: venire, jury, gore;
contain: curb, incorporate, take, stop, comprise, hold, bear;
medium: intermediate, spiritualist;
preparation: homework, cookery, grooming;
curve: veer, wind, bend, bender, arc, slue, kink, arch, crook, trend, slew;
burden: essence, load, onus, core, gist, incumbrance, encumbrance;
admitted: hold, take, intromit, include;
cross: transverse, spoil, hybridizing, hybrid, interbreed, fussy, thwartwise, hybridisation, thwart, span, interbreeding, foil, hybridize, hybridise, traverse, baffle, transversal, crabby, queer, crabbed, mark, scotch, bilk, hybridization, frustrate, intersect, grouchy, grumpy;
pound: hammer, quid, poke, ram, thump, lbf., hammering, lb, lumber, beat;
mounted: rise, wax, bestride, ride;
suffering: brook, ache, woe, tolerate, have, agony, endure, hurt, digest, wretched, excruciation, bear, abide, meet, lose, get;
singing: sear, blab, scorch, whistle, cantabile, talk, vocalizing, babble, peach, tattle;
calling: bid, shout, hollo, yell, prognosticate, phone, telephone, foretell, name, squall, career, predict, holler, cry, forebode;
agent: broker;
climbed: rise, wax;
instrument: pawn, tool;
arranged: coif, set, put, format, coiffure, do, coiffe;
belief: notion;
warning: monition, monitory, admonition, exemplary, discourage, admonitory, cautionary, monish, admonish;
count: numerate, bet, numeration, look, reckoning, calculate, enumeration, depend, weigh, enumerate, tally;
saved: keep, economise, protected, redeem, economize;
reader: lecturer, lector, subscriber;
recorded: immortalize, memorialise, commemorate, show, memorialize, immortalise, tape;
fired: dismiss, burn, elicit, kindle, enkindle, arouse, terminate, displace, can, evoke, provoke, fuel, sack;
flight: trajectory;
separated: disjointed, distinguish, classify, differentiate, dissever, sort, discriminate, secern, ramify, tell, assort, disunite, fork;
comfort: console, quilt, soothe, puff, solace, consolation, ease;
driven: compulsive, repulse, tug, labour, aim, take, ram, goaded, push, impelled, motor, repel, get;
collected: hoard, amass, equanimous, accumulate, garner;
riding: tease, free, rag, razz, tantalise, taunt, tantalize, twit, disembarrass, bait, equitation, sit, cod;
grown: turn, big, rise, maturate, farm, uprise, adult, originate, get;
lifted: wind, hoist, cabbage, uprise, hook, annul, repeal, rear, countermand, vacate, filch, overturn, elevate, snarf, plagiarise, revoke, nobble, rustle, pinch, rescind, upraised, sneak, rise, purloin, swipe, plagiarize;
confused: baffled, illogical, bedevil, discombobulate, lost, befuddled, garbled, fox, befuddle, bewildered, jumble, disoriented, fuddle, disconcert, flurry, disjointed, mazed, obnubilate, blur, disordered;
darkness: iniquity;
recognition: acknowledgement, identification, acknowledgment;
washing: lavation, lave, moisten, dampen, launder, lap, laundry, rinse;
appointed: name, prescribed, constitute, decreed;
listed: name, lean, heel;
smooth: politic, legato, suave, placid, fluent, shine, tranquil, bland, unruffled;
seeking: essay, attempt, assay, try;
origin: lineage, rootage, root, line, stemma, pedigree, ancestry, parentage, inception, bloodline, extraction;
suffered: brook, ache, tolerate, have, endure, hurt, digest, bear, abide, meet, lose, get;
helping: avail, aid, assist, facilitate;
crossed: spoil, foil, queer, interbreed, hybridize, frustrate, scotch, bilk, intersect, hybridise, baffle, traverse, thwart, span;
switch: interchange, tack, swap, permutation, transposition, swop, substitution, flip;
snake: Hydra, ophidian, serpent;
bound: bandaged, saltation, obligate, reverberate, leaping, truss, attach, tie, restrict, adhere, oblige, apprenticed, ricochet, hold, throttle, resile, constipate, leap, jump, recoil, confine, articled, trammel, indentured, restrain, destined, edge;
pilot: fly, navigate, archetype, aviate, cowcatcher, fender;
reflected: ruminate, speculate, ponder, excogitate, meditate, muse, contemplate, mull, shine;
varied: motley, alter, deviate, diverge, depart;
touched: partake, fey, allude, advert, adjoin, tint, pertain, rival, disturb, tinct, relate, stir, tinge, meet;
pocket: sack, sac, bag, scoop;
catch: view, captivate, trance, grab, get, overtake, fascinate, beguile, overhear, enchant, becharm, enamor, snap, see, haul, pinch, apprehension, gimmick, entrance, stop, enamour;
opposed: pit, counterbalance, contradict, react, controvert;
storage: reposition, memory, entrepot, warehousing, repositing, depot;
error: wrongdoing, erroneousness, misplay, mistake;
dealing: distribute, lot, contend, administer, care, dispense, apportion, take, plow, grapple, sell, cope, transaction, allot;
comment: input, remark, gloss, annotate, gossip, scuttlebutt;
visited: jaw, inflict, impose, claver, confab, chat, chaffer, inspect, chitchat, confabulate, see, chatter, natter, gossip, call;
continues: proceed, uphold, retain, remain, stay, keep;
distinguished: differentiate, describe, imposing, magisterial, mark, discern, spot, signalise, key, name, secernate, secern, recognise, tell, signalize, severalise, severalize;
match: fit, equalize, pit, compeer, equalise, pair, rival, equate, peer, correspond, jibe, tally, gibe, twin, meet, lucifer;
shift: dislodge, reposition, stir, careen, tilt, lurch, fracture, slip, budge, chemise, transmutation, agitate, transformation, sack, teddy, wobble;
brush: coppice, skirmish, clash, copse, thicket;
involves: necessitate, ask, take, require, imply, postulate, need;
composed: pen, indite;
representative: illustration, interpreter, congressman, congresswoman, spokesperson, instance;
changing: modify, vary, alter, commute, deepen;
writes: publish, compose, save, pen;
rough: rasping, approximate, fierce, jumpy, unsmooth, scratchy, grating, raspy, pugnacious, approximative, jolty, gravelly, rocky, bumpy, jolting, uncut, boisterous;
steady: firm, stabilise, unshakable, unwavering, sweetie, unfaltering, unfluctuating, brace, unbendable, calm, truelove, stabilize, becalm;
throw: drop, confound, bedevil, cast, discombobulate, bemuse, make, shed, give, hold, flip, contrive, fox, befuddle, hurl, have, bewilder, fuddle, confuse;
younger: unseasoned, untried, vernal, new, immature, untested, youthful, jr.;
demanded: necessitate, ask, take, exact, postulate, require;
missed: drop, overlook, pretermit, lost, overleap, lack, omit, lose;
shared: deal, partake, apportion;
display: show, expose;
burned: combust, bite, cut, cauterize, sting, cauterise, glow, fire, incinerate;
pride: plume, congratulate, superbia;
marketing: merchandising, commercialise, commercialize;
brings: contribute, play, fetch, wreak, take, bestow, institute, add, land, lend, work, impart, get;
discover: distinguish, expose, attain, hear, detect, key, name, reveal, unwrap, find, see;
painted: multicolour, motley, multicolor, varicoloured, calico, varicolored, multicolored, multicoloured;
focus: pore, sharpen, concentre, rivet, focalize, nidus, centre, concenter;
stepped: pace, mistreat, maltreat;
universal: worldwide, cosmopolitan;
thrown: drop, confound, bedevil, cast, discombobulate, bemuse, make, shed, give, hold, flip, contrive, fox, befuddle, hurl, have, bewilder, fuddle, confuse;
smoke: weed, sess, fume, heater, fastball, bullet, gage, pot, sens, locoweed, skunk, dope, hummer;
parallel: analog, collimate, duplicate, twin, latitude;
shear: fleece;
marine: nautical, leatherneck;
considering: view, reckon, take, deliberate, deal, believe, weigh, moot, see;
combined: merge, fuse, blend, immix, mix, aggregate, coalesce, flux;
dependent: hooked, subordinate;
assured: tell, guarantee, ascertain, see;
transportation: DoT, fare, conveyance, exile;
represents: act, play, symbolize, typify, map, be, comprise, symbolise, constitute, exemplify;
striking: coin, hit, move, dramatic, fall, scratch, salient, take, impress, expunge, spectacular, prominent, attain, mint, shine, impinging, excise;
muscle: brawniness, brawn, heftiness, sinew;
gained: hit, derive, earn, realise, benefit, win, make;
derived: deduce, gain, come, educe, infer, deduct;
express: evince, show, extract, verbalize, verbalise;
provision: purvey;
controlled: ensure, curb, ascertain, verify, insure, hold, manipulate, see;
reaching: hit, arrival, attain, accomplish, pass, give, strive, hand, make;
recall: reminiscence, retrieve, echo, withdraw;
destroyed: demolish, ruin;
defined: set, delimit, delimitate, fix;
transfer: channelise, reassign, conveyance, channelize;
flying: fell, flee, fast, aviate, vaporize, vanish;
bringing: contribute, play, fetch, wreak, take, bestow, institute, add, land, lend, work, impart, get;
studying: examine, take, perusal, meditate, analyse, contemplate, canvass, read, analyze;
corresponding: fit, like, equate, comparable, jibe, gibe, tally;
assumption: supposal, premiss, premise, effrontery;
treasury: exchequer;
represent: act, play, symbolize, typify, map, be, comprise, symbolise, constitute, exemplify;
contains: curb, incorporate, take, stop, hold, bear;
primitive: archaic, naive, rude;
handling: care, plow, deal, manipulation, treatment, palm, wield;
serving: help, assist, dish, attend, suffice, do;
track: path, racecourse, dog, rails, cut, runway, tail, lead, chase, cartroad, traverse, rail;
deeper: cryptical, recondite, mystifying, bass, abstruse, profoundly, cryptic, inscrutable, mysterious, rich;
assure: tell, guarantee, ascertain, see;
stronger: impregnable, firm, inviolable, unattackable, unassailable, potent, warm, substantial, hard;
signed: subscribe, bless, gestural, ratify;
delivered: rescue, deport, have, save, extradite, bear, cede, redeem;
formation: shaping, constitution;
swimming: float, drown, naiant;
arrangement: transcription, organisation;
drawing: eviscerate, describe, line, trace, cast, tie, get, make, draftsmanship, pull, delineate, run, puff, reap, pass, disembowel, attract, imbibe, lottery, suck, depict;
innocent: free, ingenuous, destitute, barren, sinless, unacquainted, impeccant, devoid, guiltless;
belong: go;
finish: destination, end, goal, stop, terminate, last, cultivation, cease, refinement;
noise: resound, randomness, haphazardness, racket, stochasticity, interference, dissonance;
stick: pose, spliff, cleave, puzzle, flummox, reefer, get, bind, adhere, perplex, stupefy, deposit, bond, stay, cohere, baffle, pin, wedge, nonplus, bewilder, vex, amaze, peg, dumbfound, cling, gravel, beat;
prime: choice, undercoat, select, flower, heyday, blossom, meridian, peak, efflorescence;
sleeping: slumber, kip, quiescency, dormant, quiescence, dormancy;
admit: hold, take, intromit, include;
stomach: brook, tummy, tolerate, endure, abdomen, digest, breadbasket, bear, abide, tum, venter;
constructed: retrace, fabricate, make;
device: gimmick;
tested: essay, quiz, try, examine;
organic: constituent, constitutional, constitutive;
attended: assist, advert, look, hang, see;
affected: dissemble, move, unnatural, sham, impress, feign;
guide: channelise, template, templet, manoeuvre, head, take, usher, scout, steer, channelize, pathfinder, run, pass, lead, manoeuver, maneuver, draw;
severe: spartan, dangerous, grievous, hard, knockout, terrible, wicked, stark;
release: exhaust, eject, dismissal, resign, outlet, departure, liberation, relinquish, acquittance, expel, unblock, spill, unloose, button, loss, spillage, expiration, handout, secrete, vent, dismission, publish, sacking, turn, waiver, freeing, sack, exit, unloosen;
spoken: talk, verbalise, verbalize;
equipped: fit, outfit, furnished;
managed: oversee, supervise, contend, care, negociate, superintend, grapple, deal, cope, do, wield;
occupied: tenanted, busy, take, invade, fill, reside, engross;
cleaning: pick;
being: cost, existence, live, organism, exist, embody, personify, comprise, constitute;
dressed: apparel, garb, arrange, snip, set, trim, attired, habilimented, enclothe, clip, garnish, plume, primp, groom, prune, curry, coiffure, crop, garment, garbed, clothe, lop, habilitate, decorate, coiffe, coif, do, raiment, tog;
mixed: integrate, merge, shuffle, fuse, commingle, blend, ruffle, motley, miscellaneous, sundry, interracial, conflate, amalgamate, assorted, desegregate, coalesce, flux, unify;
coating: cake;
staining: defile, maculate, maculation, sully;
sounded: go, vocalise, fathom, vocalize;
visiting: jaw, inflict, impose, claver, confab, chat, chaffer, inspect, chitchat, confabulate, see, chatter, natter, gossip, call;
challenge: gainsay, dispute;
sympathetic: charitable, openhearted, benevolent, harmonic, kindly, likable, likeable;
guard: hold, precaution;
tough: yobo, punk, problematic, hooligan, knotty, ruffianly, goon, sturdy, yob, hard, rowdy, bully, hoodlum, bad, yobbo, baffling, elusive, hood, ruffian, rugged, problematical;
jumped: parachute, skip, leap, rise, derail, startle, chute;
grade: rank, mark, form, tier;
yield: pay, soften, take, fruit, succumb, payoff, concede, takings, give, relent, afford, bear, cede, generate;
output: turnout;
producing: get, farm, grow, make;
prepare: devise, fix, organise, set, machinate, educate, groom, cook, make;
paint: key, rouge, blusher;
tongue: knife, clapper, glossa, spit;
waste: desolate, rot, dissipation, liquidate, languish, consume, barren, neutralise, scourge, squander, thriftlessness, neutralize, wild, godforsaken, ravage, emaciate, blow, macerate;
calculated: cypher, cipher, compute, bet, reckon, aim, deliberate, look, forecast, depend;
worried: vex, disquieted, care, apprehensive;
sequence: successiveness, episode, succession;
dirty: sordid, bemire, grime, begrime, unclean, soil, muddy, colly, unsporting, unsportsmanlike, cheating, pestiferous, muddied, lousy, foul, contaminating, soiled;
smell: olfaction, odour, odor, feel, look, scent, smack, flavor, reek, tone, flavour, aroma;
estimate: idea, reckon, gauge, appraisal, calculate, forecast, approximation;
sending: institutionalise, post, air, transmit, ship, broadcast, institutionalize, mail, beam;
extension: wing, lengthiness, propagation, annex, annexe, prolongation;
latest: previous, modish, tardy, former, recent;
raising: kindle, upbringing, elevation, evoke, enhance, rear, upgrade, recruit, provoke, levy, grow, elevate, nurture, enkindle, leaven, farm, stir, heighten, invoke, fosterage, elicit, arouse, conjure, promote, parent, erect, fire, resurrect, lift;
exposed: endanger, uncovered, uncover, debunk, queer, scupper, divulge, disclose, reveal, open, unwrap, peril;
retired: bed, withdraw, adjourn;
suggestion: mesmerism, prompting, trace, proffer, hypnotism, hint;
blame: damn, rap, deuced, darned, goddamn, goddam, incrimination, goddamned, infernal, inculpation, pick;
preserve: keep, uphold;
bigger: bad, bounteous, bragging, crowing, openhanded, magnanimous, prominent, freehanded, swelled, bountiful, expectant, grownup, gravid, adult, vainglorious, handsome, boastful, enceinte;
filling: take, fulfil, satiate, satisfy, replete, sate, weft, woof, meet, pick;
lying: prevarication, rest, dwell, consist, fabrication;
affect: dissemble, pretend, move, sham, impress, feign;
swept: embroil, drag, traverse, tangle, span, sail, broom;
processing: sue, work, litigate;
drunk: wino, sot, tope, inebriated, rummy, imbibe, fuddle, salute, pledge, intoxicated, booze, wassail, inebriate;
isolated: disjunct, sequestrate, marooned, quarantined, sequester;
washed: lave, moisten, dampen, launder, lap, rinse;
cloud: defile, overcast, swarm, taint, mist, obnubilate, mottle, dapple, fog, sully, befog;
stretched: load, adulterate, elongate, unfold, debase, dilute;
patent: manifest, evident, unmistakable;
rejected: spurn, spurned, disdain, disapprove, scorn;
missing: drop, overlook, pretermit, absent, overleap, lack, omit, lacking, lose;
involving: necessitate, ask, take, require, imply, postulate, need;
neutral: impersonal, achromatic;
branch: subdivision, outgrowth, offset, arm, leg, offshoot, ramify, ramification, fork, limb, furcate;
badly: mischievously, severely, disadvantageously, seriously, poorly, ill, naughtily;
determining: define, decide, fix, ascertain, set, regulate, mold, find, see;
damage: hurt, terms, harm, impairment, scathe;
worst: bad, whip, unsound, big, sorry, unfit, spoilt, defective, risky, speculative, pip, forged, uncollectible, regretful, spoiled;
jacket: crownwork, cap;
alert: merry, spanking, snappy, awake, rattling, watchful, zippy, brisk;
hunting: run, trace;
grave: weighty, dangerous, scratch, grievous, inscribe, tomb, sculpture, sedate, sculpt, solemn;
scheme: dodge, connive, dodging, intrigue, strategy;
phrase: word, articulate, idiom, formulate;
fallen: flow, accrue, devolve, diminish, precipitate, pass, come, shine, hang, descend;
dying: perish, go, choke, pall, anxious, demise, croak, expire, pass, conk, decease, exit, fail;
connected: colligate, relate, join, affiliated, link, tie;
shouting: outcry, clapperclaw, hollo, yell, blackguard, squall, exclaim, holler, cry, yelling, call;
receiving: have, obtain, incur, invite, meet, find, get;
concluded: over, terminated;
presentation: intro;
joint: articulation, articulatio, juncture, junction, spliff, roast, articulate, reefer;
returning: riposte, repay, fall, devolve, retrovert, revert, regress, reversive, pass, reelect, give, generate;
covering: incubate, masking, encompass, plow, enshroud, hatch, compensate, deal, insure, underwrite, comprehend, overcompensate, hide, brood, traverse, shroud;
proof: substantiation, validation;
magazine: clip, cartridge;
crazy: nutcase, sick, brainsick, unhinged, screwball, gaga, mad, softheaded, wild, weirdo, loony, looney, demented, dotty, unbalanced;
burst: salvo, fit, explode, fusillade, volley, collapse, erupt, abound;
variation: mutant;
gathered: conglomerate, assemble, amass, cumulate, accumulate, gain, tuck, pucker, meet;
remote: outback, distant;
testing: essay, try, quiz, examination, examine;
cooking: fake, fix, misrepresent, wangle, falsify, fudge, manipulate, make;
hurry: precipitation, rush, hastiness, hasten, zip, haste, festinate;
slipped: luxate, splay, mistake, steal, sneak, dislocate, err;
suffer: brook, ache, tolerate, have, endure, hurt, digest, bear, abide, meet, lose, get;
reflection: contemplation, thoughtfulness, musing, observation;
elaborate: complicate, exposit, refine, luxuriant, expound, rarify;
tossed: dispose, fling, convulse, thresh, sky, discard, jactitate, thrash, chuck, slash, flip;
ruled: predominate, find, rein, decree, prevail, harness, reign, govern, dominate;
allowing: tolerate, let, countenance, appropriate, earmark;
facing: veneer, confront, look;
transition: changeover;
involve: necessitate, ask, take, require, imply, postulate, need;
knocked: tap, pink, criticise, bump, ping, rap, criticize;
mature: fledged, suppurate, ripen, age, ripe, senesce, grow;
winning: succeed, fetching, victorious, gain;
checked: fit, ensure, curb, tick, ascertain, mark, tally, stop, insure, correspond, jibe, gibe, hold, retard, see;
secondary: lowly, petty, subaltern;
strain: variant, tenor, tune, form, distort, air, try, puree, line, melody, sift, sieve, filtrate, deform, nisus, song, var., filter;
ending: stop, cease, termination, terminate;
decline: fall, worsen, slump, downslope, wane, diminution;
survey: view, appraise;
quarter: billet, canton, tail, fourth, poop, draw;
stuff: hooey, englut, overindulge, clobber, binge, gourmandize, gormandize, poppycock, shove, satiate, gormandise, overgorge, lug, ingurgitate, glut, engorge, gorge, farce, overeat;
chamber: bedroom;
counter: riposte, replication, comeback, tabulator, retort, forestall, buffet, foresee, sideboard, antagonistic, parry;
locking: mesh, interlace;
grand: tremendous, lordly, terrific, imposing, idealistic, magisterial, exalted, lofty, 1000, expansive, rarified, luxurious, marvelous, thousand, sublime, wonderful, princely, K, M, opulent, sumptuous, yard, wondrous, thou, fantastic, chiliad, marvellous, G, rarefied, deluxe, howling, rattling, august, gilded;
conservative: bourgeois, cautious, materialistic;
reducing: shorten, subdue, trim, shrink, thin, abbreviate, slenderize, subjugate, slim, abridge, quash, cut, tighten, decoct, dilute, deoxidize, repress, deoxidise, foreshorten;
absolute: downright, rank, infrangible, inviolable;
matching: fit, equalize, pit, equalise, pair, rival, equate, correspond, jibe, twinned, gibe, meet, duplicate, tally;
suspect: shady, defendant, funny, fishy;
fence: surround, contend, argue, wall, palisade;
suspended: freeze, debar;
heading: channelise, maneuver, manoeuvre, aim, steer, channelize, manoeuver;
superior: ranking, victor;
network: meshing, web, mesh;
letting: have, rental, rent, countenance, get;
selling: merchandising, betray, deal;
ranging: graze, roll, browse, vagabond, straddle, swan, ramble, roam, tramp, wander, cast, run, pasture, rove, crop, rate;
lightly: thinly, softly;
substance: marrow, kernel, meat, inwardness, nub, centre, sum, pith, means, message, gist, core;
secure: safe, guarantee, impregnable, inviolable, untroubled, fix, unattackable, unassailable, good, batten, fasten, dependable, unafraid, plug;
impressed: ingrain, shanghai, move, instill;
troubled: cark, discommode, disorder, tumultuous, riotous, disoblige, inconvenience, disturb, perturb, distract, pain, unhinge, disquiet, incommode, disruptive, ail;
eating: exhaust, consume, feed, corrode, rust, deplete;
preceding: forgo, past, antedate, introduce, lead, forego, antecede;
shock: offend, jolt, jar, traumatise, traumatize, appal, jounce, scandalize, appall, scandalise, daze, blow, outrage, stupor;
blanket: panoptic, extensive, encompassing, wide;
divine: Lord, providential, elysian, Almighty, churchman, Jehovah, godlike, Creator, ecclesiastic, Maker, godly, Godhead, cleric;
abstract: pinch, snarf, nonfigurative, sneak, purloin, lift, swipe, nobble, synopsis, cabbage, precis, pilfer, hook, nonobjective, filch;
falling: lessen, flow, accrue, devolve, diminish, precipitate, pass, come, shine, descend;
concentrated: pore, rivet, hard, digest, decoct;
stable: unchanging;
utility: usefulness;
modest: meek, lowly, minor, low, mild;
ignored: cut, unheeded, dismiss, snub;
assembly: fabrication, forum;
transferred: channelise, reassign, transplant, channelize;
split: part, dissever, rive, tear, disunited, schism, cleave, fragmented, rent, rip, snag, disconnected;
exciting: rouse, commove, sex, energize, arouse, stimulate, energise, stir, agitate;
recording: transcription, immortalize, memorialise, commemorate, show, memorialize, immortalise, read, tape;
colored: dark, distort, gloss, emblazon, bleached, biased, dyed, slanted, tinge;
strip: denudate, rifle, pillage, uncase, loot, deprive, discase, undress, unclothe, peel, denude, funnies, divest, ransack, plunder, foray, disrobe, leach, despoil, dismantle, reave, bare, disinvest;
buying: corrupt, purchase, bribe;
creating: make;
poured: decant, teem, pelt, swarm, pullulate;
extend: go, prolong, gallop, protract, widen, broaden, unfold, run, pass, lead;
hoping: skip;
radical: group, ultra, extremist, base, root, stem, revolutionary;
proportion: symmetry;
trail: dog, drag, lead, chase, shack;
shadow: tincture, phantom, phantasm, dark, vestige, tail, phantasma, trace, fantasm, dwarf, apparition;
pressed: entreat, bid, urge, crusade, exhort, adjure, conjure, push, weightlift, beseech, constrict, iron, agitate, weigh;
voting: ballot;
representing: act, play, symbolize, typify, map, correspond, be, comprise, symbolise, constitute, exemplify;
debate: contend, argue, argumentation, disputation, moot;
extending: go, exsert, prolong, gallop, protract, widen, broaden, unfold, run, pass, lead;
bench: judiciary, terrace;
specified: destine, stipulate, fix, delineate, particularise, designate, set, particularize, intend, delimit, delimitate;
false: traitorously, fictitious, imitation, sham, pretended, simulated, delusive, untrue, fictive, faux, mistaken, treasonably, sour, treacherously;
encounter: happen, play, find, skirmish, confrontation, clash, bump, see, meet, showdown;
classical: authoritative, Hellenic, definitive;
expanding: boom, enlarge, amplify, inflate, lucubrate, thrive, flourish, dilate;
losing: recede, misplace, miss, mislay;
introduction: launching, unveiling, debut;
graduate: alumnus, calibrate, alum, alumna;
sacrifice: give, forfeit, forfeiture;
arise: originate, rebel, lift, grow;
wound: injury, twine, bruise, roll, meander, injure, wrap, weave, scent, hoist, hurt, lesion, spite, wreathe, nose, lift;
witness: attestor, attestator, attestant, spectator, informant, watcher, looker, viewer, find, see;
locked: mesh, interlace;
rendered: show, try, give, furnish, depict;
offering: bid, oblation, propose;
closing: fold, completion, end, windup, shutdown, culmination, conclude, shut;
colony: dependency;
tight: sloshed, nasty, wet, blotto, besotted, crocked, rigorous, fast, slopped, mingy, miserly, soused, compressed, closely, fuddled, soaked, sozzled, pissed, pixilated, mean, squiffy, taut, cockeyed;
happening: occur, occurrence, occurrent, bump, materialise, bechance, materialize, pass, find, befall;
dimension: attribute, property;
lighted: illume, fall, perch, illuminated, illumine, dismount, illuminate, unhorse;
committed: entrust, send, invest, institutionalise, pull, dedicate, institutionalize, put, consecrate, give, perpetrate, intrust, devote;
operated: go, manoeuvre, mesh, run, lock, work, manoeuver, maneuver;
acquire: take, evolve, larn, get, gain, win, grow;
doctor: sophisticate, fix, restore, mend, Dr., bushel, MD, physician;
scattered: disjointed, disperse, unconnected, illogical, dissipate, dispel, dot, sprinkle, dust, disconnected;
profound: unfathomed, fundamental, unsounded, wakeless, unplumbed;
gathering: conglomerate, assemble, amass, cumulate, accumulate, assemblage, tuck, pucker, meet;
rushed: race, hasten, hie, stimulate, festinate, induce, hotfoot;
maintaining: assert, exert, uphold, asseverate, hold, keep, conserve, wield;
distributed: diffuse, lot, disperse, stagger, administer, dispense, circularize, propagate, broadcast, deal, circularise, allot;
reserved: hold, appropriate, book, earmark;
grain: caryopsis, texture, cereal;
refer: denote, advert, consult, pertain, cite, name;
delicate: touchy, soft, frail, fragile, ticklish, finespun;
applying: utilise, implement, give, employ, hold, utilize, use, enforce;
regulation: rule, ordinance;
outer: taboo, kayoed, stunned, forbidden, proscribed, extinct, tabu, verboten, prohibited, KO'd;
passion: warmth, cacoethes, love, mania, heat, rage;
discipline: bailiwick, correction;
shoot: scud, buck, spud, bourgeon, take, tear, dash, dissipate, inject, dart, fritter, pullulate, pip, germinate, fool, photograph, snap, film;
gentle: appease, easy, mollify, aristocratic, assuage, placate, aristocratical, soft, patrician, lenify, conciliate, pacify, blue, docile;
appointment: naming, designation, date;
paying: remunerative, stipendiary, compensate, devote, compensable, give, salaried, bear, gainful;
placing: send, pose, invest, post, site, aim, set, localise, lay, put, rank, locate, localize, rate;
reform: regenerate, reclaim, rectify;
establishing: shew, show, institute, base, give, instal, launch, install, constitute, demonstrate, make;
released: turn, exhaust, eject, unblock, resign, unloose, relinquish, publish, expel, secrete, unloosen;
shopping: frequent, patronise, rat, browse, denounce, stag, betray, snitch, patronize, sponsor;
handled: care, plow, deal, palm, wield;
desperate: dire;
pointing: indicate, channelise, manoeuvre, designate, head, aim, sharpen, show, betoken, steer, channelize, taper, bespeak, luff, manoeuver, maneuver;
reserve: modesty, taciturnity, hold, backlog, stockpile, appropriate, book, earmark;
recalled: retrieve, echo, withdraw;
submarine: zep, hoagie, wedge, pigboat, bomber, undersea, hero, hoagy, torpedo;
approaching: near, forthcoming;
invited: bid, tempt;
sophisticated: convolute, pervert;
lively: merry, spanking, snappy, bouncy, racy, vital, springy, rattling, zippy, resilient, brisk;
acquired: take, evolve, larn, get, gain, win, grow;
preferred: pet, opt, favorite, favour, choose, favourite;
disturbed: interrupt, sick, brainsick, unhinged, commove, mad, demented, vex, agitate, unbalanced;
cried: outcry, shout, hollo, yell, weep, squall, exclaim, holler, call;
identify: name, describe, distinguish, key;
frozen: suspend, wintry, glacial, immobilize, frigid, icy, immobilise;
stained: defile, maculate, tarnish, sully;
staring: consummate, pure, perfect, gaze, agaze, unadulterated, arrant;
eliminate: excrete, extinguish, egest, pass, annihilate;
settlement: colonization, village, liquidation, colonisation, closure;
allowance: leeway, adjustment;
abandoned: desolate, deserted, forsake, vacate, derelict, desert;
composition: opus, penning, authorship, makeup, typography;
bearing: gestate, brook, pay, tolerate, deport, have, acquit, aim, comportment, endure, comport, digest, hold, behave, abide, mien;
prospect: vista, view, prognosis, outlook, expectation, candidate, panorama;
inspired: exalt, urge, barrack, elysian, exhort, animate, inhale, revolutionize, prompt, cheer, revolutionise, enliven;
volunteer: unpaid, Tennessean;
stretch: load, adulterate, elongate, unfold, debase, dilute;
entry: launching, unveiling, ingress, debut, incoming, submission;
breaking: go, part, bankrupt, disclose, fracture, erupt, demote, wear, infract, fail, recrudesce, transgress, soften, give, relegate, unwrap, dampen, discontinue, expose, pause, intermit, bump, divulge, smash, offend, die, interrupt, bust, stop, collapse, violate, reveal, damp;
exhibit: expose, parade, show, demo, demonstrate;
attacked: snipe, aggress, assail;
attached: bind, impound, seize, confiscate, bond, affiliated, sequester, tie;
landing: down, shore;
mobile: peregrine, nomadic, roving, wandering;
charm: tempt, appealingness, entrance, captivate, fascinate, beguile, bewitch, trance, enamour, enamor;
repeat: recur, echo, ingeminate, iterate, duplicate;
hanging: attend, flow, advert, fall;
observe: remark, detect, celebrate, keep, note, find, honour;
feeding: flow, eat, fertilize, alimentation, fertilise, give, run, prey, feast;
supporting: endorse, back, abide, encouraging, hold, affirm, tolerate, underpin, subscribe, endure, indorse, substantiate, patronize, patronise, brook, confirm, corroborate, digest, bear;
reflect: ruminate, speculate, ponder, excogitate, meditate, muse, reverberate, contemplate, mull, shine;
beard: byssus, whiskers;
transformed: metamorphose, transubstantiate;
entering: enrol, participate, inscribe, recruit, enroll, infix, ingress, introduce, accede, embark;
absorbed: plunge, ingest, enwrapped, imbibe, immerse, captive, engrossed, assimilate, suck, engulf, intent, engross, draw;
qualified: restrict, dependant, modify, stipulate, characterise, characterize, dispose;
backed: game, endorse, punt, indorse, gage;
cited: abduce, advert, summon, name, summons, adduce;
premier: PM, chancellor;
promising: hopeful, prognosticate, foretell, predict, forebode, call;
drill: practise, recitation, bore;
chance: risk, probability, bump, fortune, luck, adventure, opportunity, gamble, find;
firing: inflammation, dismiss, burn, dismissal, elicit, kindle, enkindle, arouse, dismission, terminate, displace, can, evoke, provoke, fuel, sack, ignition, sacking;
seized: usurp, sequester, clutch, impound, conquer, arrogate, confiscate, grab, appropriate, prehend, attach;
expressing: evince, show, extract, verbalize, verbalise;
faint: lightheaded, swoon, swooning, timid, deliquium, shadowy, syncope, feeble, weak, conk, wispy, vague, dim;
functional: operative, useable, usable, operable;
nearest: approximate, good, nigh, closest, cheeseparing, skinny;
aimed: take, purport, calculate, propose, purpose, get;
access: entree, admission, admittance;
excuse: apologize, condone, explain, pardon, alibi, rationalize, apologise, justify, exculpation, apology, rationalise;
interpreted: understand, construe, read, rede, see;
channel: transmit, groove, line, duct, impart;
settle: subside, decide, fall, reconcile, adjudicate, root, finalise, finalize, locate, descend, conciliate, sink, ensconce;
dedicated: give, consecrate;
relieved: unbosom, jutting, exempt, save, assuage, salvage, alleviate, allay, lighten, protruding, salve, palliate, eased, ease;
controlling: ensure, curb, ascertain, verify, insure, hold, manipulate, see;
harder: grueling, toilsome, severely, unvoiced, voiceless, backbreaking, intemperate, surd, gruelling, firmly, punishing, laborious, intemperately, operose, knockout, difficult, arduous;
cleared: exonerated, exculpate, realise, illuminate, make, authorise, exculpated, vindicated, pass, enlighten, crystalize, top, sack, exonerate, acquit, authorize, crystallize, crystalise, net, assoil, brighten, solve, crystallise, gain, elucidate, absolved;
killing: obliterate, defeat, down, cleanup, pop;
treat: dainty, plow, deal, goody, delicacy, kickshaw;
trading: swap, merchandise, sell, deal, swop;
depression: slump, imprint, low;
adjusted: conform, familiarized, adapt, set, familiarised, align, aline;
charming: tempt, wizardly, magical, entrance, captivate, fascinate, beguile, magic, sorcerous, bewitch, trance, enamour, enamor, wizard;
stuck: pose, sting, cleave, puzzle, flummox, get, bind, adhere, perplex, mystify, deposit, bond, stay, cohere, baffle, wedge, nonplus, bewilder, vex, amaze, dumbfound, cling, gravel, beat;
justified: apologize, free, absolve, vindicate, apologise, rationalize, rationalise;
giant: hulk, colossus, jumbo, whale, heavyweight, elephantine, monster, behemoth;
barrel: drum, bbl, cask;
protest: objection, dissent;
reflects: ruminate, speculate, ponder, excogitate, meditate, muse, reverberate, contemplate, mull, shine;
exposure: pic, vulnerability, photograph, photo;
belly: paunch, abdomen, venter;
excited: unrestrained, rouse, commove, sex, energize, arouse, frantic, mad, stimulate, energise, delirious, stir, emotional, agitate;
heating: ignite, wake, inflame;
registered: read, show, file;
traveled: go, move, trip, jaunt, journey, locomote;
anticipated: foreknow, forestall, foretell, foresee, predict, previse, forebode, call;
expects: gestate, bear, ask, await, look, wait, require;
carry: gestate, deport, post, transmit, take, acquit, persuade, sway, pack, stockpile, comport, run, dribble, hold, behave, bear, impart;
attending: assist, advert, look, hang, see;
suited: fit, become, befit, beseem;
earliest: former, soonest, other;
uncertain: unsure, unsettled, unsealed, changeable;
biggest: openhanded, grownup, vainglorious, bragging, expectant, swelled, bountiful, handsome, freehanded, boastful, gravid, bad, bounteous, crowing, prominent, adult, braggy, magnanimous, enceinte;
adding: contribute, bestow, summate, lend, append, sum, tally, impart, tot;
triumph: jubilate, crow, wallow, exult, rejoice, prevail, exuberate, victory, gloat;
dealt: distribute, contend, administer, care, dispense, apportion, take, grapple, plow, sell, cope;
engagement: meshing, troth, betrothal, interlocking, mesh, booking, participation, battle, date, involution;
pressing: entreat, bid, urge, crusade, exhort, urgent, adjure, conjure, push, weightlift, beseech, constrict, iron, agitate, weigh;
altered: spay, neuter, modify, vary, falsify, castrate, interpolate;
sharing: communion, partake, deal;
loaded: moneyed, crocked, affluent, pissed, sozzled, squiffy, adulterate, fuddled, wealthy, wet, debase, blotto, dilute, cockeyed, besotted;
spare: free, unembellished, unornamented, excess, surplus, trim, supernumerary, supererogatory, scanty, superfluous, redundant;
surrender: cede, capitulation, resignation, fall;
plate: home, denture;
resist: withstand, baulk, fend, balk, dissent, jib, defy;
pulling: pluck, draw, deplumate, displume, tear, rend, extract, deplume, perpetrate, rive, rip, attract, overstretch;
belongs: go;
grows: turn, rise, maturate, farm, uprise, originate, get;
searching: inquisitory, seek, trenchant, look, explore;
fault: flaw, demerit, defect, mistake, fracture;
casual: everyday, perfunctory, nonchalant, cursory, fooling, effortless, insouciant, daily;
thrust: jab, poking, jabbing, lunge, hurl, shove, poke, push, pierce, stab;
sphere: heavens, welkin, empyrean, area, domain, firmament, arena;
melting: fade, unfreeze, mellow, run, disappear, liquescent, evaporate, dissolve, unthaw, thaw, dethaw;
eliminated: excrete, extinguish, egest, pass, annihilate, obviate;
bother: fuss, discommode, rag, irritate, nettle, inconvenience, pain, annoyance, annoy, chafe, disoblige, hassle, nark, gravel, vex, incommode, rile, infliction;
preparing: devise, fix, organise, set, machinate, educate, groom, cook, make;
structural: morphological, geomorphologic, morphologic, geomorphological;
displacement: deracination;
dressing: apparel, garb, arrange, snip, set, trim, enclothe, clip, fertilization, preen, garnish, fertilisation, primp, plume, groom, prune, curry, coiffure, crop, garment, clothe, lop, habilitate, decorate, bandaging, coiffe, fecundation, coif, do, raiment, tog;
plaster: daub;
saving: deliverance, rescue, redeeming, redemptive, preservation, economize, keep, economise, economy, redeem;
delay: postponement, stay, wait, holdup, hold, retard;
questioning: interview, oppugn, doubting, interrogate, sceptical, skeptical, inquisitive, speculative, query, quizzical;
submitted: resign, reconcile, take, bow, defer, relegate, accede, posit;
forming: imprint, organise, mould, mold, work, constitute, make;
accepting: have, take, consent, bear, swallow;
stiff: sloshed, potent, cadaver, steadfast, unbendable, blotto, wet, besotted, crocked, firm, unshakable, unwavering, slopped, rigid, soused, unfaltering, fuddled, soaked, sozzled, pissed, pixilated, starchy, corpse, cockeyed, clay, buckram;
skirt: wench, parry, dodge, duck, surround, ring, evade, chick, doll, circumvent, elude, hedge, dame, fudge, sidestep, environ, bird, annulus;
seated: sit, invest, induct;
governing: regulate, regularise, regularize, rule;
profit: lucre, net, benefit, gain, earnings;
defend: hold;
crack: go, fracture, sally, cleft, topnotch, quip, gap, pass, scissure, fissure, tops, chap, shot, tornado, snap, super, fling, collapse, whirl, tiptop;
moderate: tame, soften, curb, mince, lead, centrist, hold, chasten;
inclined: tend, fain, slope, run, lean, dispose;
lowered: frown, depress;
fluid: unstable, runny;
substitute: interchange, sub, alternative, replace, ersatz, deputize, backup, reliever, deputise;
backward: feebleminded;
craft: cunning, slyness, workmanship, guile, wiliness, foxiness;
shame: dishonor, ignominy, pity, attaint, disgrace, dishonour;
envelope: gasbag;
possession: ownership, willpower, monomania;
shining: smoothen, burnished, glisten, fall, glossy, clamber, glitter, beam, sheeny, radiate, scramble, glow, lustrous, gleam, glint, sputter;
intimate: knowledgeable, suggest, cozy, confidant, adumbrate, sexual, versed;
stern: inexorable, derriere, butt, arse, seat, unrelenting, rear, backside, grim, unforgiving, ass, exacting, nates, hindquarters, unappeasable, can, relentless, prat, fanny, buttocks, tooshie, tail, bum, fundament, rump, buns, tush, poop;
smart: ache, wise, sassy, voguish, overbold, hurt, saucy, chic, impudent, impertinent;
receives: have, obtain, incur, invite, meet, find, get;
repair: restore, bushel, indemnify, revivify, amend, recompense, quicken, remediate, vivify, hangout, fixture, mending, fix, mend, animate, renovate, haunt, compensate, recreate, remedy, rectify;
grant: subsidization, accord, concede, allot, give, award, concession, cede, subsidisation;
confirmed: reassert, substantiate, corroborate;
conditioned: stipulate;
expanded: boom, enlarge, amplify, inflate, lucubrate, exposit, thrive, flourish, dilate;
decent: nice, decorous, enough, adequate, comely, properly, seemly;
flash: scud, winkle, meretricious, blink, brassy, scoot, newsbreak, trice, ostentate, dart, gimcrack, tawdry, fanfare, wink, twinkle, twinkling, gaudy, tacky, heartbeat, loud, ostentation, instant, swank, jiffy, tatty, cheap;
pitch: peddle, hawk, gear, tilt, lurch, cant, vend, sky, tar, rake, slant, monger, slope, incline, huckster, toss, flip;
strongest: impregnable, firm, inviolable, unattackable, unassailable, potent, warm, substantial, hard;
grabbed: seize, snaffle;
replacement: surrogate, permutation, renewal, transposition, substitution, refilling, successor;
nerve: boldness, spunk, steel, face, cheek, mettle;
fitted: go, suit, equip, correspond, jibe, gibe, meet, tally;
converted: reborn;
crash: clangor, clangoring, doss, clang, collapse, clank, wreck, clangour;
conversion: rebirth;
guided: channelise, maneuver, head, manoeuvre, take, steer, run, pass, lead, channelize, manoeuver, draw;
brushed: napped, fleecy;
newer: young, raw, novel, unexampled;
warrant: indorsement, endorsement, imprimatur, countenance, justify;
cream: bat, drub, lick, skim, clobber, emollient, thrash, pick, ointment;
figured: cypher, cipher, compute, reckon, visualise, envision, calculate, visualize, forecast, see;
shaking: rock, trembling, quiver, sway, stimulate, palpitation, vibration, didder, excite, agitate, stir, judder, quivering;
binding: adhere, constipate, oblige, obligate, back, truss, hold, attach, tie;
savage: feral, cruel, brutal, barbarian, furious, pillory, crucify, barbarous, wild, wolf, uncivilised, fell, vicious, fierce, ferocious, uncivilized, wildcat, roughshod, beast, barbaric, ferine, brute;
brave: fearless, unfearing, courageous, audacious, endure, dauntless, gay, intrepid, hardy;
breathing: eupneic, respire, rest, emit, eupnoeic, suspire;
devil: fiend, nark, rile, Satan, rag, annoy, daimon, gravel, Beelzebub, heller, demon, deuce, vex, ogre, hellion, Lucifer, irritate, daemon, nettle, monster, chafe, dickens;
heroic: expansive;
manage: oversee, supervise, contend, care, negociate, superintend, grapple, deal, cope, do, wield;
impulse: momentum, urge, whim, caprice;
slide: swoop, chute, coast;
screw: gaoler, shtup, eff, love, hump, bang, nooky, fuck, chouse, jailer, cheat, fucking, bonk, jazz, ass, know, jockey, bed, turnkey, jailor, chicane, shag, nookie;
inventory: stocktaking, armoury, armory;
stake: wager, bet, jeopardize, post, game, adventure, punt, gage, back, impale;
arrest: stoppage, pinch, hitch, apprehension, nab, cop, nail, stop, apprehend, halt, stay, hold, get;
ruling: predominate, find, decree, regnant, prevail, harness, govern, dominate;
discharge: exhaust, drop, eject, dismissal, emission, liberation, exculpate, expel, outpouring, run, free, exonerate, arc, acquit, venting, dismission, expelling, sacking, unload, waiver, assoil, sack, fire;
dominated: overlook, henpecked, rule, overtop, eclipse, prevail, overshadow, reign;
sailing: glide, navigation, voyage, navigate;
aroused: awake, kindle, randy, evoke, awaken, emotional, horny, provoke, ruttish, sex, steamy, enkindle, energise, stir, excite, waken, stimulated, invoke, elicit, energize, conjure, aflame, brace, stimulate, fire, wake, ablaze;
champion: virtuoso, sensation, ace, maven, admirer, paladin, mavin, protagonist, hero, adept, hotshot, whiz, friend, superstar, wizard, wiz, genius, prizewinning, star, supporter, fighter, booster, whizz;
swing: drop, lilt, dangle, cut, vacillation, sway, jive;
foundation: understructure, cornerstone, base, institution, substructure, foot, basis;
addressed: plow, accost, deal, speak, call;
bundle: cluster, package, packet, sheaf, parcel, wad, pack, pile, clump, megabucks;
register: read, show, file;
hidden: obliterate, enshroud, veil, shroud, concealed, conceal;
packed: mob, wad, throng, pile, jam, tamp;
condemned: doom, objurgate, sentence, decry, excoriate, reprobate;
allied: confederative;
venture: pretend, speculation, embark, jeopardize;
demanding: necessitate, ask, take, exact, require, postulate, need;
allows: tolerate, let, countenance, appropriate, earmark;
label: tag, mark, pronounce;
spell: turn, go, enchantment, tour, trance, while;
dated: see;
rolling: pluck, wind, swan, hustle, cast, flap, rove, trilled, undulate, tramp, wave, peal, vagabond, seethe, wander, twine, ramble, wrap, roam, revolve;
preserved: keep, save, uphold;
canvas: sail, analyze, examine, poll;
overwhelming: deluge, drown, submerge, consuming, overmaster;
harbor: entertain, shield, hold, haven, seaport;
lighting: inflammation, illume, fall, perch, ignite, illumine, dismount, illuminate, unhorse;
applies: utilise, implement, give, employ, hold, utilize, use, enforce;
broader: panoptic, extensive, unsubtle, encompassing, full, tolerant, unspecific, wide, spacious;
sketch: vignette, adumbrate, cartoon;
twisted: turn, bend, worm, distort, sophisticate, squirm, convolute, deform, wrick, rick, misrepresented, wriggle, wrench, perverted, pervert, flex, sprain;
underground: subway, metro, clandestine, tube, surreptitious;
deliver: rescue, deport, have, save, extradite, bear, cede, redeem;
proceeding: go, keep, move;
judge: approximate, evaluate, try, jurist, evaluator, pronounce;
faster: firm, degenerate, dissolute, riotous, quicker, dissipated, debauched, libertine, loyal, immobile, truehearted, degraded;
arose: originate, rebel, lift, grow;
ranged: roll, browse, vagabond, straddle, swan, roam, tramp, cast, run, pasture, rove, crop;
representation: delegacy, histrionics, theatrical, agency;
coach: autobus, manager, charabanc, carriage, jitney, omnibus, tutor, handler, motorbus, bus;
snapped: flick, bust, tear, snatch, click, rupture, photograph;
kicked: recoil, kvetch, complain, quetch;
string: draw;
prize: plunder, choice, appreciate, treasure, trophy, select, loot, lever, booty, award, esteem, swag, jimmy;
toast: crispen, goner, salute, pledge, wassail, crisp;
buried: inter, forget, interred, inhume, entomb, immerse, inhumed, sink, swallow;
escaped: miss, lam, elude, bunk, run;
acted: play, dissemble, move, do, roleplay, behave, work;
shipping: send, embark;
overhead: smash, viewgraph;
supplement: affix, postscript, accessory, addendum, appurtenance;
gather: conglomerate, assemble, amass, cumulate, accumulate, gain, tuck, pucker, meet;
disposed: toss, tending, fain, minded, apt, incline, fling;
resting: repose, breathe, perch, lie, pillow, stay;
gallery: veranda, verandah;
specialized: particularise, differentiate;
manufacture: fabrication, invent, industry, fabricate;
humble: mortify, lowly, base, low, baseborn, menial, abase, chagrin;
defended: hold;
submit: resign, reconcile, take, bow, defer, relegate, accede;
interrupted: disturb, fitful;
drift: impulsion, roll, vagabond, swan, ramble, freewheel, roam, purport, float, wander, tramp, cast, err, rove, impetus, blow, trend;
circuit: tour, lap;
relax: slack, unwind, slacken, loosen, unbend, unstrain, decompress;
deadly: lethal, baneful, venomous, pernicious, insanely, virulent, mortal, pestilent, lifelessly;
brass: boldness, face, cheek, plaque, organisation, governance;
hostile: unfriendly, uncongenial;
shifted: dislodge, reposition, careen, tilt, lurch, budge, stir, agitate, wobble;
blowing: spoil, brag, fellate, bollix, bollocks, fumble, bobble, flub, boast, muff, gasconade, swash, vaunt, bumble, bungle, fluff, suck, bluster, botch, gas, tout, float, mishandle, squander;
faded: melt, attenuate, wither, languish, pass, attenuated, bleached, evanesce, fleet, weakened, washy;
refers: denote, advert, consult, pertain, cite, name;
simpler: elementary, unproblematic, uncomplicated, bare, unsubdivided, childlike;
straightened: unbend, tidy, neaten;
roared: yawl, ululate, howl, wail, bellow, yaup;
associate: companion, connect, comrade, relate, link, consort;
assign: ascribe, attribute, delegate, arrogate, put, depute, impute, allot;
chorus: refrain;
declined: slump, wane, worsen;
separation: detachment, interval, breakup;
kingdom: realm, land;
stripped: denudate, rifle, pillage, uncase, loot, deprive, discase, undress, unclothe, peel, denude, divest, ransack, plunder, foray, disrobe, leach, despoil, dismantle, reave, bare, disinvest;
squeezed: twinge, hale, coerce, hug, bosom, wring, compress, extort, nip, mash, press, squash, shove, wedge, rack, constrict, tweet, pinch, crush, twitch, gouge;
grasp: grok, clutch, dig, clutches, clench, apprehend, savvy, comprehend, appreciation, hold;
reporting: describe, coverage;
throwing: drop, confound, bedevil, cast, discombobulate, bemuse, make, shed, give, hold, flip, contrive, fox, befuddle, hurl, have, bewilder, fuddle, confuse;
cracked: whacky, loony, bonkers, bats, nuts, barmy, roughened, alligatored, fruity, batty, daft, haywire, balmy, snap, kookie, buggy, kooky, loco, collapse, loopy, nutty, dotty;
crown: summit, pennant, pate, tip, poll, treetop, cap, diadem, top, peak;
rested: perch, pillow, lie, remain, stay;
captured: seize, conquer, entrance, fascinate, beguile, enchant, bewitch, trance, enamour, appropriate, becharm, enamor, get;
intersection: carrefour, crossroad, convergence, crossway, overlap;
counted: numerate, bet, reckon, look, depend, weigh, enumerate;
pushing: advertize, labour, tug, crusade, advertise, promote, agitate, press;
delivery: rescue;
stretching: load, adulterate, elongate, unfold, debase, dilute;
brand: stigmatise, post, stain, stigma, steel, marque, mark, denounce, stigmatize, trademark, sword, make;
shocked: offend, traumatise, traumatize, appal, scandalize, appall, dismayed, scandalise, aghast, appalled, outrage;
flood: torrent, inundate, oversupply, outpouring, deluge, glut, inundation, alluvion, overflow, swamp;
quote: cite, citation;
capture: seize, conquer, entrance, fascinate, beguile, enchant, seizure, bewitch, trance, enamour, appropriate, becharm, enamor, get;
resolved: purpose, adjudicate, decide, conclude;
expecting: gestate, bear, ask, await, look, wait, require;
progressive: imperfect, reformist, liberalist;
staying: appease, bide, rest, quell, persist, remain, outride, abide;
shorter: curt, inadequate, myopic, little, forgetful, poor, unforesightful, unretentive, brusk, brusque, scant;
collar: pinch, leash, apprehension, nab, cop, nail, apprehend, neckband;
awful: dread, tremendous, amazing, nasty, awed, dire, dreaded, unspeakable, frightfully, terrible, horrific, awesome, atrocious, abominable, awing, terribly, frightening, frightful, horrendous, fearsome;
prevailing: dominant, predominate, rule, obtain, endure, predominant, persist, run, rife, hold, dominate;
neglected: miss, drop, unattended, disregard, overlook, pretermit, overleap, unheeded, omit, ignore, fail;
obscure: obliterate, unknown, unsung, dark, overcloud, mist, obnubilate, confuse, bedim, fog, veil, unnoticeable, becloud, vague, hide, befog;
print: impress, publish, mark;
transport: channelise, conveyance, send, ravish, ship, exaltation, enrapture, delight, enthrall, enchant, enthral, channelize, ecstasy;
reverse: turn, turnaround, repeal, rescind, setback, overthrow, turnabout, lift, countermand, invert, annul, vacate, blow, rearward, overturn;
screaming: shout, hollo, yell, shriek, squall, holler, hilarious, cry, uproarious, call;
stall: shillyshally, cubicle, carrel, booth, dillydally, conk, procrastinate, kiosk;
appearing: seem, look;
gotten: pose, scram, beget, puzzle, induce, flummox, make, get, perplex, stupefy, aim, mystify, come, let, baffle, draw, grow, commence, fetch, have, engender, incur, nonplus, bewilder, vex, find, amaze, arrive, fix, take, become, dumbfound, stimulate, gravel, sire, generate, beat;
abuse: step, clapperclaw, maltreatment, revilement, shout, contumely, blackguard, mistreat, maltreat, pervert, vilification, insult;
nurse: nanny, lactate, breastfeed, entertain, suck, suckle, hold, harbour;
disturbing: interrupt, commove, distressful, vex, agitate, worrisome;
draft: tipple, enlist, muster, conscription, swig, blueprint, gulp, potation;
ticket: tag, fine, slate;
quest: bespeak, bay, pursuance;
clearing: exculpate, unclutter, realise, illuminate, glade, authorise, make, pass, enlighten, crystalize, top, sack, exonerate, acquit, authorize, crystallize, crystalise, net, assoil, brighten, solve, crystallise, elucidate;
legitimate: decriminalize, licit, decriminalise, logical, lawful;
bounced: recoil, resile, ricochet, reverberate;
pitching: peddle, hawk, gear, tilt, lurch, cant, vend, sky, monger, slope, incline, slant, huckster, toss, flip;
spotted: blemish, blob, distinguish, fleck, descry, discern, spy, blot, espy, recognise;
hitting: stumble, slay, murder, gain, dispatch, pip, off, make, tally;
commit: entrust, send, invest, institutionalise, pull, dedicate, institutionalize, put, consecrate, give, perpetrate, intrust, confide, devote;
collect: hoard, amass, accumulate, garner, cod;
import: implication, significance, signification, consequence;
mount: backing, rise, wax, bestride, ride;
document: papers;
breed: spawn, multiply, engender;
tracing: delineate, describe, decipher, line, hunt, hound, draw;
wanting: require, absent, need, deficient;
translated: read, understand;
fancy: phantasy, illusion, partiality, visualise, envision, visualize, fondness, see;
fringe: outskirt, periphery, bang;
shake: waggle, tremble, rock, trill, sway, stimulate, wag, handclasp, stir, excite, agitate, judder, didder;
reflecting: ruminate, speculate, ponder, excogitate, meditate, muse, reverberate, contemplate, mull, shine;
matched: fit, equalize, pit, equalise, pair, rival, equate, correspond, jibe, gibe, twin, meet, tally;
traveling: go, move, trip, jaunt, journey, locomote;
shell: case, crush, husk, cuticle, casing, trounce, vanquish, carapace, beat;
orientation: preference;
secular: layperson, worldly, profane, laic, temporal, lay, layman;
switched: swop, tack, swap, flip;
maintains: assert, exert, uphold, asseverate, hold, keep, conserve, wield;
translate: read, understand;
conjunction: alignment;
twist: wind, convolute, wrick, tress, wrench, plait, bend, pull, eddy, rick, deform, spin, pervert, sophisticate, wriggle, crook, winding, turn, worm, gimmick, squirm, kink, flex, whirl, braid, sprain;
spreading: distribute, diffuse, dissemination, disperse, circularize, scatter, propagate, broadcast, unfold, open, circulate, circularise, disseminate;
lined: describe, draw, seamed, trace;
confined: restrict, imprisoned, jailed, detain, restrain, enclose, captive, hold, throttle, trammel, circumscribe;
resume: CV, restart;
heated: ignite, wake, inflame;
vertical: upright, perpendicular, erect;
ruined: bankrupt, deflower, smash, destroy, sunk;
alarm: horrify, dismay, appal, appall, consternation;
compound: intensify, heighten, deepen;
declaration: announcement;
refuse: defy, deny, garbage, scraps;
buffer: soften, cushion, cowcatcher, polisher;
referring: denote, advert, consult, cite, name, relate;
orbit: scope, area, revolve, domain, arena;
sober: unplayful, drab, sedate;
abandon: desolate, wildness, forsake, wantonness, unconstraint, vacate, desert;
bleeding: haemorrhage, hemorrhage, run, leech, phlebotomise, phlebotomize;
alien: noncitizen, foreigner, unknown, extraterrestrial, outlander, foreign, exotic, estrange, stranger, disaffect;
proposition: proffer;
occupy: busy, take, invade, fill, reside, engross;
wasted: haggard, liquidate, languish, consume, neutralise, otiose, bony, squandered, gaunt, scourge, cadaverous, purposeless, senseless, desolate, rot, pinched, skeletal, superfluous, pointless, squander, neutralize, ravage, emaciate, blow, macerate;
fitting: go, suit, equip, outfit, correspond, jibe, gibe, accommodation, adjustment, meet, tally;
spray: atomiser, nebulizer, nebuliser, atomizer;
hiding: obliterate, conceal, concealment, enshroud, veil, shroud, concealing;
leveling: equalization, rase, dismantle, equalisation, grading, razing, raze;
oppose: pit, counterbalance, contradict, react, controvert;
decrease: lessen, minify, fall, reduction, diminish, diminution, lessening;
boost: encourage, rise, encouragement, hike, supercharge, further;
drain: debilitate, enfeeble;
wider: panoptic, extensive, encompassing, full, spacious;
explosion: blowup;
dropping: flatten, pretermit, overleap, cast, expend, shed, deteriorate, sink, fell, degenerate, overlook, spend, omit, unload, miss, dismiss, devolve, dangle, dribble;
operates: go, manoeuvre, mesh, run, lock, work, manoeuver, maneuver;
blast: boom, pillory, flak, clap, flack, nail, eruption, bang, smash, fire, blow, crucify, gust;
landed: down, shore;
reward: advantage, payoff, reinforcement, reinforce, wages, honour;
batting: lick, drub, clobber, thrash, flutter;
scored: nock, hit, mark, tally, make;
trick: prank, deception, fox, thaumaturgy, illusion, john, whoremonger, caper, magic, fob, whoremaster, legerdemain, conjuration, joke;
smashed: boom, ruin, crocked, bankrupt, pixilated, sozzled, squiffy, crush, demolish, nail, fuddled, wet, blotto, slopped, cockeyed, besotted;
dragging: haul, cart, embroil, hale, tangle, puff, scuff, dredge;
knock: criticize, tap, pink, criticise, belt, bash, bump, ping, rap, bang, whack, roast, whang, smash;
staged: snoop, shop, rat, arrange, denounce, spy, snitch, shit, sleuth, betray;
assault: ravish, ravishment, dishonor, violate, snipe, rape, violation, dishonour, outrage;
battery: barrage, bombardment;
qualify: restrict, modify, stipulate, characterise, characterize, dispose;
heavier: weighty, gruelling, sullen, cloggy, fleshy, laborious, lumbering, arduous, intemperate, sonorous, expectant, clayey, impenetrable, toilsome, backbreaking, ponderous, punishing, wakeless, gravid, grueling, laboured, overweight, threatening, big, grievous, dense, operose, leaden, enceinte;
swinging: drop, dangle, vacillation, sway, tripping, lilting;
penetration: insight;
dragged: haul, cart, embroil, hale, tangle, puff, scuff;
restricted: curtail, curb, confine, throttle, trammel;
stirred: arouse, conjure, budge, evoke, excite, agitate, invoke;
joining: link, connect, connexion;
crude: unrefined, raw, blunt, earthy, vulgar, unprocessed, oil, petroleum, stark;
sweep: slam, embroil, drag, traverse, tangle, expanse, span, sail, broom;
considers: view, conceive, reckon, take, deliberate, deal, believe, weigh, moot, see;
straw: husk, wheat, shuck, chaff, stubble;
shower: cascade, exhibitioner, lavish, exhibitor;
exhausted: eject, sap, fagged, consume, tire, spent, fatigued, deplete, expel, tucker, beat;
distress: hurt;
freezing: immobilise, immobilize, suspend;
arranging: transcription, format, set, put, coif, coiffure, do, coiffe;
plunged: souse, douse, dip, dump, dive, dunk, immerse, engulf, launch, engross;
touching: partake, allude, advert, adjoin, pertain, rival, disturb, tinct, relate, stir, poignant, meet;
stirring: inspiration, arouse, conjure, budge, evoke, stimulate, excite, agitate, invoke;
vanished: fell, fly, disappear;
sustained: confirm, corroborate, prolong, have, nurture, hold, keep, affirm, nourish, get;
dissolved: melt, unfreeze, unthaw, thaw, dethaw;
packing: mob, take, wad, boxing, throng, pile, jam, tamp;
cracking: groovy, peachy, dandy, keen, fracture, collapse, nifty, swell, neat, snap, bully;
needle: goad;
printing: impress, publish;
farming: agricultural, land, agriculture, husbandry, grow;
flashed: scud, winkle, scoot, swank, wink, twinkle, ostentate, blink, dart, flaunt;
picking: cull, nibble, plunk, beak, foot;
eliminating: excrete, extinguish, egest, pass, annihilate, obviate, eradicate;
border: ring, abut, surround, adjoin, perimeter, delimitation, mete, butt, environ, moulding, edge;
dismissed: drop, terminate, displace, can, fire, sack, ignore;
nursing: lactate, breastfeed, suck, suckle, hold, harbour;
combine: merge, cartel, fuse, blend, immix, mix, meld, aggregate, coalesce, flux;
arises: originate, rebel, lift, grow;
organize: devise, form, machinate, mastermind, unionise, orchestrate, engineer;
fails: go, bomb, die, miscarry, flunk, betray;
marching: abut, parade, adjoin, butt, edge, demonstrate;
transit: theodolite;
loses: recede, misplace, miss, mislay;
failing: go, bomb, die, weakness, miscarry, betray;
engage: enlist, pursue, betroth, affiance, plight, charter, take, lock, mesh, hire, prosecute, employ, rent, engross;
bothered: discommode, rag, irritate, nettle, inconvenience, disoblige, annoy, fazed, nark, gravel, vex, incommode, rile, daunted, chafe;
upset: disquieted, derangement, disorder, swage, disordered, overthrow, untune, disturb, upturned, discomfit, disconcert, perturbation, turnover, overturned, discompose, overturn;
fastened: tighten, fix;
proceeds: go, move, take, payoff, takings, keep;
pursued: chased;
executed: fulfill, accomplish, run, fulfil, perform, do;
valued: prise, appreciate, precious, appraise, assess, esteem, treasure, rate;
pickup: getaway, cartridge;
appealing: likable, attract, invoke, likeable;
feather: plume, plumage, fledge;
polished: smoothen, refined, milled, down, urbane, refine, shine, svelte;
organ: harmonium;
framed: couch, entrap, ensnare, put, cast, compose;
rounded: labialise, snipe, labialize, assail;
oldest: Old, previous, quondam, erstwhile, onetime, former, sometime;
penetrating: diffuse, riddle, imbue, knifelike, keen, incisive, click, infiltrate, pervade, dawn, discriminating, fathom;
emerging: egress;
clearer: readable, exculpated, percipient, decipherable, vindicated, exonerated, open, unclouded, unmortgaged, absolved;
accommodate: fit, suit, reconcile, oblige, hold, conciliate;
relaxed: slack, unwind, slacken, loosen, unbend, unstrain, decompress;
remembering: commend, memory, commemorate, retrieve, recollect;
answering: respondent, respond, reply, suffice, do;
cleaned: pick, scavenge;
nearer: approximate, good, nigh, cheeseparing, skinny;
retreat: withdraw, recede, hideaway, crawfish;
projected: jut, contrive, jutting, plan, visualise, envision, cast, externalise, visualize, externalize, see;
solitary: unfrequented, nongregarious, recluse, lonesome, hermit, troglodyte, lone, lonely, nonsocial;
sustain: confirm, corroborate, prolong, have, nurture, hold, keep, affirm, nourish, get;
climax: orgasm, culmination;
coordinated: align, organise, interconnected;
coupled: linked, twin, pair, mate;
bubble: eruct, belch, burp, ripple;
confederate: accomplice, henchman, collaborator;
bathing: washup;
conditioning: stipulate;
wrapped: twine, envelop, roll, wind, enfold, clothed, cloaked, mantled, engrossed, captive, enclose, intent;
determines: fix, ascertain, set, regulate, mold, find, see;
molding: casting, form, mildew, regulate, cast, forge, work;
singular: funny, odd, queer, unique, curious, remarkable, rummy, rum;
blank: dummy, vacuous;
chill: frisson, gelidity, pall, shivering, shudder, iciness, quiver, tingle, cool, shiver;
relieve: unbosom, exempt, save, assuage, salvage, allay, lighten, remedy, palliate, ease;
spring: bounce, form, outflow, leap, saltation, jump, give, rebound, recoil, reverberate, ricochet, fountain, resile;
expand: boom, enlarge, amplify, inflate, lucubrate, exposit, thrive, flourish, dilate;
restrained: intimidate, cumber, unemotional, encumber, confine, hold, keep, throttle, trammel;
gaining: derive, hit, earn, realise, benefit, attain, win, make;
adopt: espouse, take, dramatise, dramatize, borrow;
corruption: rottenness, putrefaction, subversion, putrescence, degeneracy, depravity, depravation, putridness;
convey: fetch, transmit, take, impart, get;
acute: piercing, penetrative, knifelike, intense, keen, incisive, discriminating, needlelike;
absorb: plunge, ingest, imbibe, immerse, assimilate, suck, engulf, engross, draw;
defending: hold;
belonging: go;
brooding: ruminative, loom, hover, pensive, incubate, dwell, hatch, meditative, reflective, incubation, stew, pout, grizzle, contemplative, pensiveness, sulk, musing;
beaten: exhaust, pose, trounce, quiver, vanquish, drum, flap, ticktock, puzzle, flummox, outwit, get, perplex, stupefy, mystify, thrum, ticktack, tick, nonplus, thump, bewilder, bunk, outsmart, vex, amaze, overreach, outfox, crush, pulsate, circumvent, scramble, dumbfound, gravel, tucker;
tumbled: topple, twig, tip, collapse, whirl;
collapsed: crumple, give, tumble, crumble;
stopping: discontinue, quit, fillet, end, kibosh, terminate, intercept, barricade, halt, bar, cease;
lowest: scurvy, humbled, humiliated, dispirited, down, grim, depleted, downhearted, scummy, abject, gloomy, blue;
steep: unconscionable, usurious, plunge, infuse, outrageous, immerse, engulf, exorbitant, extortionate, engross;
utter: consummate, pure, everlasting, perfect, dead, thoroughgoing, talk, emit, speak, verbalize, unadulterated, sodding, stark, verbalise, arrant;
lasting: go, persistent, live, endure, survive, permanent, durable;
conducting: deport, acquit, take, transmit, deal, lead, comport, behave, bear, impart;
smallest: lowly, belittled, little, minor, low, minuscule;
miserable: scurvy, pathetic, woeful, paltry, hapless, poor, low, pitiful, scummy, abject, wretched, piteous;
classified: relegate, assort, sort;
collecting: hoard, aggregation, amass, accumulate, garner, compile, assembling;
consumed: ware, exhaust, devour, have, take, eat, ingest, down, squander, deplete;
forcing: pull, hale, coerce, ram, wedge, push, storm, impel, draw;
creates: make;
blockade: hinder, obstruct, stymie, stop, encirclement, stymy, embarrass, bar;
tempted: invite, lure, entice, allure;
posture: stance, attitude, carriage, sit;
rocket: arugula;
rubber: safe, golosh, caoutchouc, galosh, prophylactic, condom, gumshoe, arctic;
sheer: downright, bold, vapourous, slue, gossamer, filmy, cobwebby, perpendicularly, unmixed, slew, diaphanous, cut, bluff, gauzy, vaporous, unmingled, rank, transparent, trend;
embrace: espouse, encompass, hug, comprehend, bosom;
remembers: retrieve, commemorate, commend, recollect;
vocal: outspoken, song;
execution: slaying, performance, murder;
induced: rush, have, hasten, stimulate, make, get;
fusion: merger, unification, coalition;
decay: decomposition, disintegrate, decompose, disintegration, dilapidate, crumble;
communicate: transmit, pass;
patch: plot, darn, mend, dapple, maculation, bandage, spot, speckle, fleck, while;
deepest: cryptical, recondite, mystifying, bass, abstruse, cryptic, inscrutable, mysterious, rich;
enters: participate, inscribe, infix, recruit, introduce, accede, embark;
thread: wind, meander, weave, yarn, wander, ribbon, draw;
romance: coquette, solicit, mash, woo, coquet, philander, dally, flirt, butterfly;
curled: coil, loop, kink, wave;
assuming: usurp, sham, don, seize, take, arrogate, presume, simulate, wear, bear, presumptuous, feign;
opposing: pit, counterbalance, contradict, react, controvert;
leveled: dismantle, raze, rase;
ordering: regularize, dictate, regulate, enjoin, put, consecrate, rank, say, tell, regularise, prescribe, rate;
dwelling: live, home, consist, lie, populate, habitation, harp, domicile, abode, brood, inhabit;
blade: sword, steel, vane;
waving: roll, wafture, undulate, beckon, flap, flourish, curl, brandish;
insert: introduce, infix, tuck, enclose;
charcoal: fusain;
sealed: varnish;
compass: grok, dig, apprehend, savvy, ambit, comprehend, circumnavigate;
receiver: liquidator;
scream: shrieking, shout, hollo, wow, yell, squall, howler, riot, holler, cry, sidesplitter, call;
manifold: multiply, multiplex;
abstraction: generalization, generalisation;
nucleus: core, karyon;
incorporated: merged;
whipped: flog, blister, lash, trounce, scald, lather, pip, welt, slash, strap;
harsh: abrasive;
contended: grapple, argue, cope, deal, vie, postulate, repugn;
resolve: decide, adjudicate, conclude, firmness, purpose;
believing: conceive;
focused: pore, sharpen, concentre, rivet, centre, concenter;
acknowledge: recognise, receipt;
blocked: impede, obturate, jam, freeze, barricade, halt, stymy, obstruct, occlude, deflect, bar, lug, immobilise, parry, plugged, hinder, forget, stymie, immobilize, stop, kibosh, embarrass;
lighter: easy, barge, swooning, abstemious, unaccented, flatboat, hoy, wanton, weak, unclouded, promiscuous, wakeful, tripping, idle, scant, sluttish;
kicking: kvetch, boot, recoil, quetch, complain;
newest: young, New, raw, unexampled, novel;
layer: bed, stratum;
purse: wrinkle, handbag, bag, pocketbook;
acknowledged: recognise, receipt;
crashed: ram, doss;
challenging: gainsay, dispute, ambitious, intriguing;
realizing: earn, agnize, understand, substantiate, gain, actualise, agnise, recognise, actualize, make, see;
sweeping: embroil, drag, traverse, tangle, wholesale, sail, broom;
extends: go, exsert, prolong, gallop, protract, widen, broaden, unfold, run, pass, lead;
compact: heavyset, compendious, thickset, summary, wad, stocky, press, succinct;
convert: commute;
counting: numerate, bet, numeration, reckon, look, calculate, enumeration, depend, weigh, enumerate, tally;
daring: boldness, venturesome, audacious, venturous, presume, defy, hardihood;
resort: hangout, haunt, refuge;
stray: roll, vagabond, swan, divagate, ramble, digress, roam, wander, cast, rove, err;
suspension: dangling, pause, abeyance, reprieve, intermission, hiatus, abatement, interruption, respite;
yielded: pay, soften, succumb, concede, give, relent, afford, bear, cede, generate;
compounded: intensify, heighten, deepen;
absorption: engrossment, preoccupancy, immersion, preoccupation;
swallowed: withdraw, immerse, bury, unsay;
traced: delineate, describe, decipher, line, hunt, hound, draw;
thunder: boom, roar, skag, smack, roaring, scag;
cooler: nerveless, tank;
eaten: feed, rust, corrode, consume;
pleading: beseeching;
hardened: indurate, set, inure, inured;
antique: outmoded, ex, demode, passee, oldtimer, passe, gaffer;
pretending: dissemble, act, simulation, sham, profess, feign, make;
stone: pit, rock, lapidate, gem, endocarp;
discount: dismiss, ignore, rebate, disregard;
molded: shaped, form, regulate, cast, wrought, forge, work;
crest: tip, cap, top, summit, peak;
swollen: tumefy, tumesce, egotistic, conceited, vain, intumesce, egotistical;
processed: sue, work, litigate;
leaning: tend, tilt, proclivity, tip, tilted, tipped, propensity, tendency, run, inclination, canted, list, incline, atilt;
wrinkled: unironed, furrow, rumple, scrunch, crisp, crumple, crease;
terminal: end, last, depot, pole, concluding;
hollow: vacuous, excavate, dig;
fulfilled: accomplish, satisfy, meet, execute;
concentrate: decoct, digest, pore, rivet;
doubled: twofold, reduplicate, replicate;
outline: schema, synopsis, precis, adumbrate;
declares: adjudge, announce, hold;
squeeze: twinge, hale, coerce, hug, bosom, wring, compress, extort, nip, mash, press, clinch, squash, shove, wedge, rack, constrict, tweet, pinch, crush, twitch, gouge;
proven: essay, shew, rise, show, try, test, testify, demonstrate, examine;
premium: bounty, agio, agiotage;
observing: remark, detect, celebrate, keep, note, find, honour;
posted: mail;
timing: clock;
nailed: boom, cop, nab, pinpoint, apprehend, peg, ace, smash;
shaken: jolted, rock, sway, stimulate, stir, excite, agitate, judder, didder;
slice: cut, gash, slash, fade;
array: align, raiment, regalia;
loading: adulterate, cargo, debase, consignment, dilute, shipment, freight;
integrated: mix;
scratching: scrub, inscribe, expunge, cancel, chafe, rub, itch, engrave, excise, fret, fray;
treating: regale, plow, deal;
lodge: guild, auberge, inn, gild, club, hostelry, deposit, society, file, hostel;
planted: embed, imbed, set, institute, ingrained, engraft, constitute;
deduction: synthesis, entailment;
breast: knocker, tit, boob, titty, bosom, summit;
shade: tincture, spectre, subtlety, specter, nicety, tint, ghost, wraith, spook, tone, refinement, nuance;
wired: cable, pumped, electrify, telegraph;
appreciated: comprehended, treasure, revalue;
marking: nock, tag, stigmatise, pit, differentiate, tick, commemorate, scar, pock, denounce, set, punctuate, stigmatize, note, distinguish;
fixing: neutering, restore, bushel, set, desex, get, reparation, make, fastener, deposit, posit, cook, altering, desexualize, fasten, fixture, mending, desexualise, sterilise, unsex, mend, holdfast, situate, sterilize;
mounting: rise, wax, bestride, ride;
laying: put, repose, set, pose;
shifting: dislodge, unfirm, careen, tilt, lurch, budge, agitate, wobble;
interpret: understand, construe, read, rede, see;
unified: merge, commix, incorporate, merged, interconnected, mix, amalgamate, mingle;
temper: pique, pettishness, toughness, peevishness, humour, irritation, surliness, normalize, snappishness, harden, mollify, chasten, irritability, anneal, mood, biliousness;
nominal: titular, tokenish, token;
carrier: postman, newsboy, flattop, mailman, toter;
purple: violet, royal, regal, imperial, majestic;
recover: reclaim, find, regain, convalesce;
settling: subsidence, subside, decide, fall, reconcile, adjudicate, root, finalise, descend, finalize, locate, subsiding, conciliate, ensconce;
divide: fraction, dissever, part, watershed;
trusted: hope, believe, rely, sure, bank, confide, swear;
limiting: define, restrict, constraining, fix, set, confining, constrictive, restrain, confine, throttle, trammel, circumscribe;
twisting: convolute, wrick, wrestle, wrench, twirl, voluminous, bend, rick, deform, pervert, distort, sophisticate, tortuous, wriggle, overrefinement, torture, turn, worm, squirm, writhe, flex, whirl, sprain;
develops: modernise, rise, evolve, formulate, explicate, modernize, educate, uprise, grow, originate, germinate, recrudesce, get;
restraint: simplicity, simpleness, chasteness;
render: show, try, give, furnish, depict;
awkward: ungainly, sticky, embarrassing, clumsy, bunglesome, unenviable, uneasy, inept, inapt, cumbersome;
secured: guarantee, fix, batten, fasten, plug;
hardest: grueling, toilsome, severely, unvoiced, voiceless, backbreaking, intemperate, surd, gruelling, firmly, punishing, laborious, intemperately, operose, knockout, difficult;
depressed: dismay, dispirited, down, dispirit, downcast, grim, low, deject, demoralize, gloomy, blue;
bursting: erupt, abound, collapse, explode;
floating: swim, aimless, vagabond, vagrant, blow;
hazard: risk, pretend, jeopardize, jeopardy, fortune, luck, adventure, endangerment, gamble, peril;
bronze: tan;
polish: smoothen, glossiness, down, gloss, burnish, refine, cultivation, shine, refinement;
anticipate: foreknow, forestall, foretell, foresee, predict, previse, forebode, call;
oriented: tailor;
distorted: twine, colour, warp, misshapen, deform, falsify, perverted, garble, malformed, tinge, wring;
agrees: fit, harmonize, accord, concord, correspond, jibe, gibe, harmonise, hold, concur, consort, tally;
strained: laboured, distort, puree, try, sieve, sift, deform, agonistic, filter;
curse: excommunicate, whammy, bane, maledict, condemnation, torment, execration, anathemise, imprecate, anathemize, swearing, blaspheme, jinx, oath, bedamn, swearword, nemesis, unchurch, damn, beshrew, hex, expletive, swear;
reject: spurn, disdain, cull, disapprove, scorn;
rendering: show, try, give, interpretation, furnish, generate, depict;
neglect: miss, drop, disregard, pretermit, disuse, overlook, overleap, omit, carelessness, ignore, nonperformance, fail;
fatigue: pall, outwear, weariness, wear, weary, tiredness, jade;
tender: crank, bid, pinnace, tippy, raw, warm, untoughened, lovesome, cranky, stamp, sore, fond, affectionate;
indifferent: immaterial, deaf, unbiased, unbiassed, apathetic;
endured: brook, go, tolerate, live, persist, survive, last, run, digest, wear, prevail, bear, abide;
arising: lift, rebel, uprise, grow;
bloom: rosiness, blush, heyday, efflorescence, peak, flower;
locating: fix, site, situate, placement, emplacement;
flush: moneyed, crimson, boot, bang, blossom, redden, outpouring, kick, affluent, efflorescence, scour, even, heyday, wealthy, peak, flower, rosiness, thrill, purge, sluice;
rotating: circumvolve, revolve, splay;
specify: define, destine, stipulate, fix, delineate, particularise, designate, set, particularize, intend, delimit, delimitate;
climb: upgrade, rise, wax, ascent, acclivity;
construct: retrace, fabricate, make;
adopting: espouse, take, dramatise, dramatize, borrow;
revealing: uncover, expose, divulge, disclosure, disclose, unveil, telltale, unwrap;
deciding: determinative, adjudicate, determinant;
liking: care, wish;
spinning: twirl, birl, reel, gyrate, whirl;
rubbing: scratch, detrition, friction, fray, itch, fret, chafe;
detached: free, unaffectionate, uncaring, uninvolved;
crawl: cower, grovel, creep, fawn, creeping, cringe;
rally: tease, mobilize, muster, razz, taunt, summon, tantalize, twit, rebound, mobilise, bait, ride, tantalise, cod;
spark: actuate, twinkle, trip, trigger, flicker, glint, activate;
coordinate: align, organise;
simplest: elementary, unproblematic, uncomplicated, childlike, bare, unsubdivided, mere;
unite: merge, connect, link, join;
patronage: championship, clientele, backing, disdain, backup, condescension;
denying: abnegate, traverse;
streak: bar, mottle, run, blotch;
completing: dispatch, nail;
swelling: intumescency, jut, intumescence, protrusion, tumefy, protuberance, bump, bulge, lump, hump, tumesce, gibbousness, extrusion, gibbosity, puffiness, excrescence, prominence, intumesce;
rushing: race, hasten, hie, haste, stimulate, festinate, induce, hotfoot;
slashed: whip, convulse, flog, cut, thresh, trounce, jactitate, thrash, welt, strap, toss;
elevated: rarefied, rarified, upgrade, idealistic, sublime, promote, lofty, el, lift;
lease: charter, take, rental, hire, rent;
margin: leeway, tolerance, perimeter;
poised: brace, equanimous;
guiding: channelise, maneuver, head, manoeuvre, take, steer, run, pass, lead, directive, channelize, manoeuver, directional, draw;
disturbance: disruption, ruffle, kerfuffle, commotion, fray, affray, folie, flutter;
judging: approximate, gauge, evaluate, adjudicate, try, pronounce;
founder: flop, collapse, give, laminitis, beginner;
freed: dislodge, liberate, absolve, unblock, resign, disengage, exempt, unloose, relinquish, disembarrass, justify, unloosen;
alternate: tack, surrogate, understudy, jump, flip;
urging: advocate, goad, inspire, spur, exhort, importunity, prod, cheer, recommend, press, barrack;
declaring: adjudge, announce, hold;
climbing: rise, wax;
glowing: burn, radiate, shine, beam, radiance;
descent: lineage, fall, downslope, filiation, line, stemma, pedigree, ancestry, parentage, bloodline, extraction;
combining: merge, fuse, blend, immix, conflate, mix, meld, aggregate, coalesce, flux;
assuring: guarantee, ensure, insure, tell, see;
crushed: humbled, squash, beat, humiliated, demolish, trounce, low, vanquish, oppress, jam, smash, mash, suppress, squelch;
risen: rear, wax, rebel, lift, jump, originate, heighten, resurrect, grow;
recognizes: distinguish, accredit, greet, discern, spot, realise, know;
harvest: glean, crop, reap;
diminished: lessen, fall, belittled, belittle, lessened, atrophied, vitiated, weakened;
